Wo, Wo, Wo, Wo, Wo, Ww, Ww, Ww, Ds, Ds, Gd^Fp, Gd^Fp, Gd^Fp, Hh, Hh^Fp, Hh, Mm, Mm, Mm, Hh, Hh, Hh, Gs
Wo, Wo, Wo, Wo, Wo, Ww, Ww, Ww, Ds, Ds, Gll^Vo, Gd^Fmw, Gd^Fmw, Hh, Hh, Mm, Hh^Vo, Mm, Hh, Hh, Gs, Gs, Hh
Wo, Wo, Wo, Wo, Ww, Ww, Ww, Ww, Ds, Gd^Fp, Gd^Fp, Gd^Fp, Gd^Fp, Hh^Fp, Hh, Hh, Hh, Hh, Hh, Gs, Hh, Hh, Mm
Wo, Wo, Ww, Wo, Ww, Ww, Ww, Ds^Edt, Gs^Edt, Gd^Fp, Gd^Fp, Gd^Fmw, Gd^Fp, Hh, Gd^Fp, Hh^Fp, Hh, Hh, Gs, Gs, Hh^Vo, Mm, Mm
Wo, Wo, Ww, Ww, Ww^Edt, Ww^Edt, Ds, Ds^Edt, Gs, Gs, Gg, Gd^Fmw, Gd^Fp, Gd^Fmw, Gd^Fp, Gd^Fp, Gs, Gs, Hh, Hh, Mm, Mm, Mm
Wo, Wo, Ww, Ww, Ww^Edt, Ds, Ds, 2 Gs^Edt, Gs, Gs, Gg, Gg, Gd^Fp, Gd^Fmw, Gd^Fp, Gd^Fp, Gs, Hh, Hh, Mm, Mm, Mm, Mm
Ww, Ww, Ww^Edt, Ww^Edt, Ds^Edt, Ds, 1 Gs^Edt, Gs, Gs, Gs, Gg^Es, Gg, Gd^Fp, Gd^Fmw, Gd^Fp, Gd^Fmw, Gs, Hh^Fp, Gd^Fp, Hh, Hh, Hh^Vo, Hh
Ww, Ww, Ww^Edt, Ds^Edt, Ds, Gs^Edt, Gs, Gs, Gs, Gs^Es, Co, Ko, Gs^Es, Gd^Fp, Gs, Gs, Gd^Fp, Gd^Fp, Gd^Fp, Hh, Hh, Gd^Fp, Hh
Ww, Ww, Ds, Ds, Gs^Edt, Gs^Edt, Gs, Gs, Gs, Co, Co, Co, Gd^Fp, Gs, Gd^Fp, Gd^Fp, Gd^Fp, Gd^Fp, Gd^Fp, Hh^Fp, Gd^Fp, Gd^Fp, Hh
Ds, Ww, Ds, Ds^Edt, Gs, Gs, Gg, Gg, Gg^Es, Ko, Gd^Fp, Gd^Fp, Gd^Fp, Gs, Gs^Vo, Gd^Fp, Gd^Fp, Gd^Fp, Gd^Fmw, Gd^Fmw, Gd^Fmw, Gd^Fp, Hh
Ds, Ds, Gd^Fp, Gd^Fp, Gd^Fp, Gg, Gd^Fp, Gg, Gd^Fp, Gd^Fp, Gd^Fp, Gd^Fp, Gs, Gs, Gd^Fp, Gd^Fp, Gd^Fp, Gd^Fp, Hh^Fp, Gd^Fp, Hh, Hh^Fp, Hh
Gd^Fp, Gd^Fp, Gd^Fp, Gd^Fp, Gd^Fmw, Gd^Fp, Gd^Fmw, Gd^Fmw, Gd^Fmw, Gd^Fmw, Gd^Fp, Gs, Gd^Fmw, Gd^Fp, Gd^Fmw, Gd^Fmw, Gd^Fp, Gd^Fp, Hh, Gd^Fp, Hh^Fp, Hh, Hh
Gd^Fp, Gll^Vo, Gd^Fp, Gd^Fp, Gd^Fp, Gd^Fmw, Hh, Gd^Fp, Gd^Fmw, Gd^Fetd, Gd^Fmw, Gd^Fmw, Gd^Fmw, Gd^Fmw, Gd^Fp, Gd^Fp, Gd^Fp, Hh^Fp, Hh, Hh, Hh, Hh, Hh
Gd^Fp, Gd^Fp, Gd^Fp, Gd^Fp, Gd^Fp, Gd^Fp, Hh^Vo, Hh, Gd^Fp, Gd^Fmw, Gd^Fp, Gd^Fp, Gd^Fmw, Gs, Gs^Vo, Gd^Fp, Gd^Fp, Hh^Fp, Gd^Fmw, Gd^Fmw, Hh, Hh^Fp, Hh
Gd^Fp, Gd^Fp, Gd^Fmw, Gd^Fmw, Gd^Fp, Hh, Hh, Hh^Fp, Gd^Fp, Gd^Fp, Ss, Ss, Gd^Fmw, Gs, Gs, Gd^Fp, Gd^Fp, Gd^Fp, Gd^Fp, Ss, Hh^Fp, Hh, Hh
Gd^Fp, Gd^Fmw, Gd^Fmw, Gd^Fmw, Gd^Fmw, Gd^Fp, Gd^Fmw, Hh, Hh, Hh, Ss, Ss, Gd^Fdw, Gd^Fmw, Gd^Fdw, Gs, Gd^Fdw, Ss, Gd^Fdw, Ss, Ss, Ss, Ss
Gd^Fp, Gd^Fp, Gd^Fp, Gd^Fmw, Gd^Fdw, Ss, Hh, Hh^Fp, Hh, Ss, Ss^Vhs, Ss, Ss, Gd^Fdw, Ss, Gd^Fdw, Rd, Ss, Gd^Fdw, Gd^Fdw, Ss^Vhs, Ss, Ss
Gd^Fp, Gd^Fp, Gd^Fmw, Gd^Fmw, Gd^Fdw, Ss, Ss, Ss, Ss, Ss, Ss, Ss, Ss, Gd^Fdw, Ss, Ss, Rd, Ss, Ss, Gd^Fdw, Gd^Fdw, Gd^Fdw, Gd^Fdw
Hh, Gd^Fmw, Gd^Fmw, Gd^Fmw, Ss^Vhs, Ss, Ss, Rd, Rd, Rd, Ss, Rd, Rd, Ss, Rd, Ss, Ss, Rd, Ss, Rd, Rd, Gd^Fdw, Gd^Fdw
Hh, Gd^Fmw, Gd^Fdw, Ss, Ss, Ss, Hh, Ss, Ss, Rd, Rd, Rd, Rd, Ss^Vhs, Rd, Ss, Ss, Ss, Rd, Rd, Rd, Gd^Fdw, Gd^Fdw
Hh, Hh, Hh, Ss, Mm, Hh, Ss, Ss, Rd, Rd, Ss, Rd, Rd, Rd, Rd, Rd, Rd, Ss, Ss, Cte, Rd, Rd, Rd
Mm, Mm, Mm, Mm, Hh, Hh^Fp, Hh, Ss, Ss, Ss, Ss, Ss, Ss, Rd, Ss, Rd, Ss, Rd, Ss, 3 Kte, Ss, Rd, Ss
Mm, Mm, Mm, Mm, Mm, Hh, Hh, Hh, Ww, Ss, Ss, Ss, Ww, Ss, Ss, Ss, Ss, Ss, Ss, Ss, Ss, Ss, Ss
