Wo, Wo, Wo, Wo, Wo, Ww, Ww, Ww, Ds, Ds, Gd^Fp, Gd^Fp, Gd^Fp, Hh, Hh^Fp, Hh^Fp, Hh^Fp, Hh^Fp, Hh^Fp, Hh^Fp, Hh, Hh, Gs
Wo, Wo, Wo, Wo, Wo, Ww, Ww, Ww, Ds, Ds, Gll^Vht, Gd^Fmw, Gd^Fmw, Hh, Hh, Hh, Hh^Vc, Hh, Hh, Hh, Gs, Gs, Hh
Wo, Wo, Wo, Wo, Ww, Ww, Ww, Ww, Ds, Gd^Fp, Gd^Fp, Gd^Fp, Gd^Fp, Hh^Fp, Hh, Hh, Hh, Hh^Fp, Hh, Gs, Hh, Hh, Hh^Fp
Wo, Wo, Ww, Wo, Ww, Ww, Ww, Ds, Gs, Gd^Fp, Gd^Fp, Gd^Fmw, Gd^Fp, Hh, Gd^Fp, Hh^Fp, Hh, Hh, Gs, Gs, Hh^Vc, Hh, Hh^Fp
Wo, Wo, Ww, Ww, Ww, Ww, Ds, Ds, Gs, Gs, Gg, Gd^Fmw, Gd^Fp, Gd^Fmw, Gd^Fp, Gd^Fp, Gs, Gs, Hh, Hh, Hh, Hh^Fp, Hh^Fp
Wo, Wo, Ww, Ww, Ww, Ds, Ds, 2 Gs, Gs, Gs, Gg, Gg, Gd^Fp, Gd^Fmw, Gd^Fp, Gd^Fp, Gs, Hh, Hh, Hh^Fp, Hh, Hh^Fp, Hh^Fp
Ww, Ww, Ww, Ww, Ds, Ds, 1 Gs, Gs, Gs, Gs, Gg^Es, Gg, Gd^Fp, Gd^Fmw, Gd^Fp, Gd^Fmw, Gs, Hh^Fp, Gd^Fp, Hh^Fp, Hh, Hh^Vc, Hh^Fp
Ww, Ww, Ww, Ds, Ds, Gs, Gs, Gs, Gs, Gs^Es, Chr, Khr, Gs^Es, Gd^Fp, Gs, Gs, Gd^Fp, Gd^Fp, Gd^Fp, Hh, Hh, Gd^Fp, Hh^Fp
Ww, Ww, Ds, Ds, Gs, Gs, Gs, Gs, Gs, Chr, Chr, Chr, Gd^Fp, Gs, Gd^Fp, Gd^Fp, Gd^Fp, Gd^Fp, Gd^Fp, Hh^Fp, Gd^Fp, Gd^Fp, Hh^Fp
Ds, Ww, Ds, Ds, Gs, Gs, Gg, Gg, Gg^Es, Khr, Gd^Fp, Gd^Fp, Gd^Fp, Gs, Gs^Vht, Gd^Fp, Gd^Fp, Gd^Fp, Gd^Fmw, Gd^Fmw, Gd^Fmw, Gd^Fp, Hh^Fp
Ds, Ds, Gd^Fp, Gd^Fp, Gd^Fp, Gg, Gd^Fp, Gg, Gd^Fp, Gd^Fp, Gd^Fp, Gd^Fp, Gs, Gs, Gd^Fp, Gd^Fp, Gd^Fp, Gd^Fp, Hh^Fp, Gd^Fp, Hh, Hh^Fp, Hh^Fp
Gd^Fp, Gd^Fp, Gd^Fp, Gd^Fp, Gd^Fmw, Gd^Fp, Gd^Fmw, Gd^Fmw, Gd^Fmw, Gd^Fmw, Gd^Fp, Gs, Gd^Fmw, Gd^Fp, Gd^Fmw, Gd^Fmw, Gd^Fp, Gd^Fp, Hh, Gd^Fp, Hh^Fp, Hh, Hh
Gd^Fp, Gll^Vht, Gd^Fp, Gd^Fp, Gd^Fp, Gd^Fmw, Hh, Gd^Fp, Gd^Fmw, Gd^Fetd, Gd^Fmw, Gd^Fmw, Gd^Fmw, Gd^Fmw, Gd^Fp, Gd^Fp, Gd^Fp, Hh^Fp, Hh, Hh, Hh, Hh, Hh
Gd^Fp, Gd^Fp, Gd^Fp, Gs, Gs, Gs, Hh^Vc, Hh, Gd^Fp, Gd^Fmw, Gd^Fp, Gd^Fp, Gd^Fmw, Gs, Gs^Vht, Gd^Fp, Gd^Fp, Hh^Fp, Gd^Fmw, Gd^Fmw, Hh, Hh^Fp, Hh
Gd^Fp, Gd^Fp, Gd^Fmw, Gd^Fmw, Gs, Hh, Hh, Hh^Fp, Gd^Fp, Gd^Fp, Ss, Ss, Gd^Fmw, Gs, Gs, Gd^Fp, Gd^Fp, Gd^Fp, Gd^Fp, Ss, Hh^Fp, Hh, Hh
Gd^Fp, Gd^Fmw, Gs, Gs, Gd^Fmw, Gd^Fp, Gd^Fmw, Hh, Hh, Hh, Ss, Ss, Gd^Fdw, Gd^Fmw, Gd^Fdw, Gs, Gd^Fdw, Ss, Gd^Fdw, Ss, Ss, Ss, Ss
Gd^Fp, Gd^Fp, Gd^Fp, Gd^Fmw, Gd^Fdw, Ss, Hh, Hh^Fp, Hh, Ss, Ss^Vhs, Ss, Ss, Gd^Fdw, Ss, Gd^Fdw, Rd, Ss, Gd^Fdw, Gd^Fdw, Ss^Vhs, Ss, Ss
Gd^Fp, Gd^Fp, Gd^Fmw, Gd^Fmw, Gd^Fdw, Ss, Ss, Ss, Ss, Ss, Ss, Ss, Ss, Gd^Fdw, Ss, Ss, Rd, Ss, Ss, Gd^Fdw, Gd^Fdw, Gd^Fdw, Gd^Fdw
Hh, Gd^Fmw, Gd^Fmw, Gd^Fmw, Ss^Vhs, Ss, Ss, Rd, Rd, Rd, Ss, Rd, Rd, Ss, Rd, Ss, Ss, Rd, Ss, Rd, Rd, Gd^Fdw, Gd^Fdw
Hh, Gd^Fmw, Gd^Fdw, Ss, Ss, Ss, Hh, Ss, Ss, Rd, Rd, Rd, Rd, Ss^Vhs, Rd, Ss, Ss, Ss, Rd, Rd, Rd, Gd^Fdw, Gd^Fdw
Hh^Fmw, Hh^Fmw, Hh, Ss, Hh, Hh, Ss, Ss, Rd, Rd, Ss, Rd, Rd, Rd, Rd, Rd, Rd, Ss, Ss, Cte, Rd, Rd, Rd
Hh, Hh^Fmw, Hh, Hh, Hh, Hh^Fmw, Hh, Ss, Ss, Ss, Ss, Ss, Ss, Rd, Ss, Rd, Ss, Rd, Ss, 3 Kte, Ss, Rd, Ss
Hh, Hh, Hh, Hh^Fmw, Hh, Hh, Hh, Hh, Ww, Ss, Ss, Ss, Ww, Ss, Ss, Ss, Ss, Ss, Ss, Ss, Ss, Ss, Ss
