Mm, Mm, Mm, Hh, Hh, Hh, Hh, Hh, Hh, Gg, Hh, Hh, Mm, Mm, Mm, Mm, Mm, Mm, Mm, Mm, Hh, Hh, Hh^Fp, Hh^Fp, Gll^Fp, Gll^Fp, Ww, Ww, Wo, Wo, Hh, Mm, Mm
Mm, Mm, Gll^Fp, Gll^Fp, Gll^Fp, Gg, Gg, Gg^Vo, Hh, Hh^Fp, Hh, Hh, Hh, Mm, Hh, Mm, Hh, Mm, Hh, Hh, Gd^Vo, Hh, Gg, Gll^Fp, Gg, Gll^Fp, Wo, Wo, Wo, Wo, Hh, Mm, Mm
Rd, Rd, Rd, Rd, Rd, Rd, Rd, Gll^Fp, Gll^Fp, Gll^Fp, Gll^Fp, Hh, Gd, Hh, Hh, Hh, Gd, Hh, Hh, Gd, Hh, Hh, Gg, Gg, Ww, Wo, Wo, Wo, Co, Co, Co, Mm, Mm
Mm, Mm, Hh, Gg, Gll^Fp, Gg, Gg, Rd, Gll^Fp, Gll^Fp, Gg, Gg, Gg^Es, Gd, Gd, Gd, Gd, Gd, Gd, Gd, Gd, Hh, Hh, Hh, Ww, Wo, Wo, Co, Co, 3 Ko, Co, Mm, Mm
Mm, Mm, Hh, Hh, Hh^Fp, Hh, Gg, Rd, Cer, Cer, Cer, Gg, Gg, Gg, Hh, Hh, Hh, Hh, Hh, Gd, Hh, Hh, Hh, Hh, Hh, Wo, Wo, Rd, Co, Co, Hh, Mm, Mm
Mm, Mm, Hh, Hh, Hh, Hh, Gg, Cer, 1 Ker, 2 Ker, Cer, Gs, Hh, Gg, Hh, Mm, Hh, Hh, Mm, Hh, Hh, Hh, Hh, Ww, Wo, Wo, Wo, Rd, Gg, Gg, Hh, Mm, Mm
Mm, Mm, Hh, Gd, Gd, Gg, Gg, Cer, Cer, Cer, Rd, Gg, Gg, Hh, Hh, Mm, Hh^Fp, Hh, Hh, Hh, Mm, Hh, Ww, Ww, Wo, Wo, Rd, Rd, Gg, Gg, Hh, Hh, Hh
Mm, Hh, Gd, Gd, Hh, Hh, Gd, Gg, Gg, Gg, Gg, Rd, Rd, Gg, Hh, Hh, Gg^Vo, Hh, Mm, Mm, Mm, Hh, Hh, Wo, Wo, Rd, Gg, Gg, Hh, Gg^Vo, Hh, Hh, Mm
Mm, Hh, Hh, Gd, Gd, Gd, Hh, Hh, Hh, Hh, Hh, Gg, Hh, Rd, Hh, Gg, Hh^Fp, Hh, Mm, Mm, Mm, Hh, Ww, Wo, Wo, Rd, Gg, Hh, Hh, Hh, Hh, Mm, Mm
Hh, Hh^Vo, Hh, Hh, Gg, Gd, Gd, Gd^Vo, Hh, Hh, Hh, Gg, Hh, Rd, Rd, Gg, Hh^Fp, Hh, Hh, Hh, Mm, Ww, Wo, Wo, Ww, Rd, Gg, Gg^Vo, Hh, Hh, Hh, Hh, Mm
Hh, Hh, Hh, Gg, Gg, Gg, Gg, Hh, Hh, Hh, Hh, Hh, Hh, Gg, Ww, Rd, Ww, Ww, Ww, Hh, Ww, Ww, Wo, Wo, Rd, Rd, Gg, Hh, Hh, Mm, Mm, Mm, Mm
Ww, Ww, Wo, Ww, Ww, Ww, Wo, Ww, Ww, Ww, Ww, Ww, Wo, Ww, Wo, Wo^Bw|, Wo, Ww, Wo, Ww, Wo, Wo, Rd, Rd, Gg, Gg, Gg^Vo, Hh, Hh, Mm, Mm, Mm, Mm
Wo, Wo, Wo, Wo, Wo, Wo, Wo, Wo, Wo, Wo, Wo, Wo, Wo, Wo, Wo, Wo^Bw|r, Wo, Wo, Wo, Wo, Wo, Ww, Ss^Bw|, Gg, Gd^Fp, Hh, Hh, Hh, Mm, Mm, Mm, Mm, Mm
Ww, Wo, Ww, Wo, Wo, Wo, Ww, Wo, Ww, Ww, Ww, Ww, Gll^Fp, Wo, Wo, Wo^Bw|, Ss, Wo, Ss, Wo, Ww, Ww, Rd, Ss, Ss, Hh^Fp, Hh, Hh^Fp, Mm, Hh^Vo, Hh, Mm, Mm
Ww, Ww, Hh, Ww, Hh, Ww, Gg, Hh, Hh, Ss, Ss, Gll^Fp, Gll^Fp, Gg, Gg, Rd, Rd, Ss, Ss, Ss, Rd, Rd, Gg, Ss, Ss, Hh^Fp, Hh, Gd, Gd, Hh, Gd, Hh^Vo, Mm
Hh, Hh, Hh, Hh, Gg, Gg, Hh, Hh, Hh, Hh, Ss, Gll^Fp, Gg, Gg, Rd, Rd, Gg, Rd, Rd, Ss^Bw/, Ss, Gg, Hh, Gg^Vo, Ss, Hh, Mm, Hh, Hh, Gd, Hh, Hh, Hh
Mm, Mm, Mm, Mm, Gg, Hh, Gg, Hh, Gg^Vo, Hh, Ss, Ss, Rd, Rd, Gg, Gg, Gg, Gll^Fp, Gg^Vo, Gll^Fp, Ss, Gg, Hh, Hh, Ss, Hh, Mm, Hh^Vo, Hh, Gd, Mm, Hh, Hh
Mm, Mm, Mm, Gg, Gg, Hh, Gg, Gg, Rd, Ss, Rd, Ss^Bw/, Ss, Gll^Fp, Gg^Vo, Gg, Gg, Gg, Gll^Fp, Gll^Fp, Ss, Ss, Ss, Hh, Hh, Ss, Mm, Mm, Mm, Mm, Hh^Vo, Hh, Hh
Hh, Hh, Mm, Gg, Co, Gg, Co, Rd, Ww, Rd, Wo, Ww, Gll^Fp, Gll^Fp, Gll^Fp, Gg, Gg, Gll^Fp, Ss, Gll^Fp, Ss, Hh^Fp, Hh^Fp, Ss, Mm, Mm, Mm, Mm, Mm, Mm, Hh, Hh, Hh
Hh, Hh, Hh, Co, 4 Ko, Co, Gg, Rd, Ww, Wo, Wo, Wo, Wo, Gll^Fp, Gll^Fp, Gll^Fp, Gg^Vo, Gll^Fp, Ss, Ss, Hh^Fp, Hh^Fp, Mm, Ss, Mm, Mm, Mm, Mm, Mm, Mm, Gd, Hh, Hh
Hh, Hh, Hh, Co, Co, Co, Gg, Rd, Rd, Wo, Wo, Wo, Wo, Wo, Wo, Gll^Fp, Gll^Fp, Gll^Fp, Ss, Hh^Fp, Hh^Fp, Mm, Mm, Mm, Hh^Vo, Mm, Hh, Hh^Vo, Mm, Hh, Gd, Hh, Hh
Mm, Hh, Hh^Vo, Hh, Hh, Hh, Hh, Gg, Rd, Ww, Gg, Wo, Wo, Wo, Wo, Gll^Fp, Wo, Ww, Wo, Ss, Mm, Mm, Hh^Fp, Hh^Fp, Hh, Mm, Hh, Hh, Gd, Gd, Hh, Hh, Mm
Mm, Hh, Hh, Hh, Hh^Fp, Hh, Hh^Fp, Gll^Fp, Hh, Rd, Rd, Ww, Ww, Wo, Ww, Wo, Wo, Wo, Ww, Hh^Fp, Hh^Fp, Hh^Fp, Ww, Hh, Hh, Hh, Hh, Hh, Hh, Gd, Mm, Hh, Mm
Mm, Hh, Hh, Gd, Gd, Gd, Hh, Gll^Fp, Hh^Fp, Gg, Gg, Rd, Rd, Rd, Rd, Rd, Rd, Ww, Ww, Hh^Fp, Hh^Fp, Wo, Wo, Ww, Wo, Ww, Hh, Hh, Hh, Gd, Hh, Mm, Mm
Mm, Mm, Hh, Hh, Mm, Gd, Gd, Hh, Hh^Fp, Hh, Gg^Vo, Gg, Gll^Fp, Gll^Fp, Hh^Fp, Hh, Gg, Rd, Rd, Ww, Ww, Ww, Gll^Fp, Wo, Ww, Wo, Wo, Ww, Hh, Hh, Hh^Vo, Mm, Mm
Mm, Mm, Hh^Vo, Hh, Mm, Gd, Hh, Hh, Mm, Hh, Hh, Hh^Fp, Hh^Fp, Hh, Hh, Hh, Gg, Gg, Gll^Fp, Rd, Gg, Gll^Fp, Gll^Fp, Gll^Fp, Gll^Fp, Ww, Wo, Ww, Ww, Mm, Mm, Mm, Mm
Mm, Mm, Mm, Mm, Mm, Gd, Hh^Vo, Hh, Mm, Hh, Hh, Hh, Hh^Fp, Mm, Mm, Hh, Hh, Hh, Gll^Fp, Rd, Rd, Gll^Fp, Gll^Fp, Gll^Fp, Gll^Fp, Gll^Fp, Ww, Wo, Wo, Ww, Mm, Mm, Mm
Mm, Mm, Mm, Mm, Mm, Mm, Hh, Mm, Mm, Hh, Hh, Gd, Hh, Mm, Mm, Hh, Hh, Hh, Gll^Fp, Hh^Fp, Hh, Rd, Rd, Gg^Vo, Gg, Gll^Fp, Co, Co, Ww, Wo, Ww, Mm, Mm
Mm, Mm, Mm, Mm, Hh^Vo, Mm, Mm, Mm, Mm, Hh^Vo, Mm, Gd, Hh, Hh^Vo, Mm, Hh, Hh, Gll^Fp, Hh, Hh^Fp, Hh, Gll^Fp, Gll^Fp, Rd, Rd, Gg, Co, Co, Co, Wo, Mm, Mm, Mm
Mm, Hh^Fp, Hh^Fp, Hh^Fp, Hh^Fp, Mm, Mm, Mm, Mm, Mm, Mm, Gd, Gd, Hh, Hh, Hh, Hh, Hh, Hh^Vo, Mm, Hh, Hh^Fp, Gg, Gll^Fp, Gg, Rd, Co, 5 Ko, Co, Wo, Wo, Ww, Mm
Hh^Fp, Hh^Fp, Hh^Fp, Hh^Fp, Hh^Fp, Mm, Hh^Fp, Hh^Vo, Mm, Mm, Mm, Mm, Mm, Gd, Mm, Hh, Gd, Hh, Hh, Mm, Hh, Hh^Fp, Gg, Gg, Gg^Vo, Rd, Co, Co, Hh, Ww, Hh, Wo, Wo
Hh^Fp, Hh^Fp, Hh^Fp, Hh^Fp, Hh^Fp, Hh^Fp, Hh^Fp, Hh^Fp, Mm, Mm, Mm, Mm, Mm, Mm, Mm, Hh, Mm, Gd, Hh, Hh, Hh, Hh, Hh, Hh^Fp, Gll^Fp, Rd, Rd, Hh, Hh, Hh, Hh, Hh, Hh
Hh^Fp, Hh^Fp, Hh^Fp, Hh^Fp, Hh^Fp, Hh^Fp, Hh^Fp, Hh^Fp, Hh^Fp, Mm, Mm, Mm, Mm, Mm, Mm, Mm, Mm, Hh, Hh, Hh, Hh, Hh, Hh, Gll^Fp, Gll^Fp, Gll^Fp, Rd, Hh, Hh, Hh, Hh, Hh, Hh
