Rd, Mm, Mm, Mm, Mm, Mm, Mm, Hh, Mm, Mm, Mm, Mm, Mm, Hh, Hh, Hh, Hh, Hh, Gs^Fp, Gs^Fp, Gs^Fp, Gs^Fp, Gs^Fp, Gs^Fp, Gs^Fp, Gs^Fp, Gs^Fp, Wo, Wo, Wo, Ww, Hh, Hh
Mm, Rd, Rd, Mm, Mm, Mm, Mm, Mm, Mm, Mm, Hh, Hh, Hh, Hh, Hh, Hh, Hh, Gs^Fp, Rd, Gg^Vo, Rd, Gs^Fp, Gg^Vo, Gs^Fp, Ww, Ww, Wo, Wo, Wo, Wo, Ww, Hh, Hh
Mm, Mm, Mm, Rd, Rd, Hh, Hh, Hh, Hh, Hh, Hh, Hh, Gg, Hh, Rd, Rd, Rd, Rd, Hh, Rd, Gs^Fp, Rd, Gg, Gg, Ww, Wo, Wo, Wo, Co, Hh, Co, Hh, Hh
Mm, Mm, Mm, Hh, Rd, Hh, Gg, Hh, Gg, Hh, Gg, Gg, Gg^Es, Gg, Gs^Fp, Gs^Fp, Hh^Fp, Hh, Mm, Hh, Gs^Fp, Gs^Fp, Gg, Ww, Wo, Wo, Wo, Rd, Co, 3 Ko, Co, Hh, Hh
Mm, Hh, Mm, Mm, Hh, Rd, Rd, Gg, Cer, Cer, Cer, Gg, Gg, Gg, Hh, Hh^Fp, Hh, Mm, Hh^Fp, Hh^Fp, Hh, Gs^Fp, Wo, Wo, Wo, Wo, Wo, Rd, Rd, Rd, Rd, Hh, Hh
Mm, Hh, Mm, Mm, Hh, Gg, Cer, Rd, Rd, 1 Ker, Cer, Gg, Gg^Vo, Hh, Hh, Hh, Gg, Hh, Hh^Fp, Hh, Ww, Ww, Wo, Wo, Wo, Wo, Gg, Gg, Rd, Rd, Rd^Vo, Hh, Mm
Mm, Hh, Hh, Mm, Hh, Gg, Cer, 2 Ker, Cer, Rd, Rd, Gg, Hh, Hh, Gg, Gg, Hh, Hh, Gs^Fp, Hh, Ww, Wo, Wo, Wo, Ww, Ww, Gg, Rd, Hh, Hh, Hh, Mm, Mm
Mm, Hh, Hh, Hh, Rd, Gg, Gg, Cer, Gg, Gg, Rd, Gg, Gg, Hh, Gg, Hh, Gs^Fmw, Hh, Gs^Fmw, Ww, Wo, Wo, Wo, Wo, Gg, Gs^Fp, Rd, Rd, Gg^Vo, Hh, Hh, Mm, Mm
Hh, Hh, Gg, Hh, Rd, Gg, Gg^Vo, Gg, Hh, Gg, Hh, Rd, Rd, Gg, Rd, Gg, Gg^Vo, Gs^Fmw, Gs^Fp, Wo, Wo, Wo, Gs^Fp, Gg, Rd, Rd, Gg, Gg, Hh, Hh, Mm, Mm, Mm
Hh, Hh, Gg, Hh, Rd, Hh, Gll^Fp, Hh, Hh, Gg, Hh, Gg, Gg, Rd, Gg^Vo, Rd, Gs^Fp, Gs^Fp, Wo, Wo, Wo, Wo, Gs^Fp, Rd, Hh, Gg, Hh, Hh, Hh, Hh, Mm, Mm, Mm
Hh, Hh, Hh, Rd, Gg, Hh, Hh, Hh^Fp, Hh^Fp, Hh, Hh^Fp, Gs^Fmw, Gs^Fp, Gg, Gs^Fp, Rd, Wo, Wo, Wo, Wo, Ww, Ww, Gg, Rd, Hh, Gs^Fp, Hh^Vo, Hh^Fp, Mm, Mm, Mm, Mm, Mm
Hh, Hh, Hh, Rd, Gs^Fp, Gs^Fp, Gs^Fp, Gs^Fmw, Rd, Rd, Hh, Hh, Gs^Fp, Gs^Fp, Wo, Rd, Wo, Wo, Wo, Ww, Gs^Fp, Gg, Rd, Rd, Hh, Hh^Fp, Hh, Hh, Mm, Mm, Mm, Mm, Mm
Hh, Hh, Gg^Vo, Gg, Rd, Gg, Gg^Vo, Gs^Fp, Gg, Gg, Gs^Fp, Gs^Fp, Ww, Wo, Wo, Wo^Bw|, Wo, Wo, Ww, Ww, Gs^Fp, Rd, Hh, Gg, Hh, Hh, Mm, Mm, Mm, Hh^Vo, Mm, Mm, Mm
Hh, Hh, Gg, Gg, Gg, Rd, Gg, Gg, Ww, Ww, Ww, Ww, Wo, Wo, Wo, Wo^Bw|, Wo, Ww, Gg, Gs^Fp, Rd, Rd, Hh, Gg, Hh^Vo, Mm, Mm, Mm, Hh, Rd, Hh, Mm, Mm
Ww, Ww, Ww, Ww, Ww, Ww, Wo, Ww, Wo, Wo, Wo, Wo, Wo, Wo, Wo, Wo^Bw|, Gg, Gg, Rd, Rd, Gg^Vo, Rd, Rd, Hh, Hh, Mm, Mm, Mm, Rd, Rd, Hh, Mm, Mm
Wo, Wo, Wo, Wo, Wo, Wo, Wo, Wo, Wo, Wo, Wo, Wo, Gs^Fp, Gs^Fp, Gg^Vo, Rd, Rd, Rd, Hh, Hh, Gs^Fp, Hh, Hh, Rd, Gs^Fp, Mm, Hh, Hh, Rd, Hh, Mm, Mm, Mm
Wo, Wo, Wo, Wo, Ww, Wo, Ww, Wo, Ww, Ww, Wo, Ww, Wo, Gg, Rd, Rd, Gg, Gg, Hh, Hh^Fmw, Hh^Fp, Hh, Rd, Rd, Rd, Gs^Fp, Rd, Hh, Hh, Mm, Mm, Mm, Mm
Ww, Ww, Ww, Ww, Gs^Fp, Ww, Gs^Fp, Ww, Gs^Fp, Ww, Wo, Wo, Wo^Bw/, Wo^Bw/, Wo, Hh, Hh^Vo, Hh, Gg, Hh, Hh^Vo, Hh, Rd, Hh, Hh, Rd, Hh, Hh, Mm, Mm, Mm, Mm, Mm
Gs^Fp, Gs^Fp, Gs^Fmw, Gs^Fp, Co, Gs^Fp, Co, Gs^Fp, Rd, Gg, Rd, Wo^Bw/, Wo, Wo, Ww, Hh, Hh, Gs^Fp, Hh, Hh, Hh^Fp, Gs^Fp, Hh, Rd, Hh, Hh, Mm, Mm, Mm, Mm, Mm, Hh, Mm
Gs^Fmw, Gs^Fmw, Mm, Co, 4 Ko, Co, Rd, Rd, Rd, Rd, Rd, Gg, Ww, Wo, Wo, Ww, Ww, Hh, Ww, Hh, Hh, Gs^Fmw, Gs^Fetd, Rd, Rd, Hh, Gs^Fmw, Mm, Hh, Mm, Rd, Hh^Vo, Mm
Mm, Mm, Mm, Mm, Co, Co, Rd, Gg^Vo, Gg, Gg^Vo, Rd, Gs^Fp, Gs^Fp, Ww, Hh, Wo, Wo, Ww, Wo, Hh, Ww, Gs^Fp, Gs^Fp, Gs^Fmw, Gs^Fp, Rd, Gs^Fp, Hh^Vo, Hh, Hh, Rd, Hh, Mm
Mm, Mm, Mm, Hh, Hh, Rd, Hh, Hh, Hh, Gg, Gg, Rd, Rd, Hh, Ww, Wo, Ww, Wo, Ww, Wo, Wo, Wo, Wo, Hh^Fp, Hh, Rd, Rd, Hh^Fp, Rd, Rd, Mm, Mm, Mm
Mm, Mm, Hh, Hh, Hh, Rd, Hh, Mm, Hh, Gs^Fp, Hh, Hh, Rd, Gg, Gll^Fp, Ww, Gg, Ww, Gll^Fp, Ww, Hh, Ww, Wo, Ww, Ww, Hh, Hh^Fp, Rd, Hh, Mm, Mm, Mm, Mm
Mm, Mm, Mm, Hh, Hh, Hh, Mm, Mm, Hh^Fmw, Hh^Fmw, Hh^Fp, Gg^Vo, Rd, Rd, Rd, Hh, Rd, Gll^Fp, Rd, Hh, Gg, Ww, Ww, Wo, Hh, Hh, Hh, Hh, Hh^Vo, Hh^Fp, Mm, Mm, Mm
Mm, Mm, Hh^Vo, Hh, Mm, Mm, Mm, Mm, Mm, Hh, Hh, Hh, Rd, Gg, Gg, Rd, Hh, Rd, Hh, Rd, Rd, Gg, Ww, Wo, Ww, Hh, Ww, Gs^Fp, Hh, Gs^Fp, Gs^Fp, Mm, Mm
Mm, Mm, Mm, Mm, Mm, Mm, Mm, Hh^Fp, Hh^Fp, Mm, Hh, Hh, Rd, Gs^Fmw, Hh, Hh, Hh, Hh, Rd, Hh, Rd, Gg^Vo, Gs^Fp, Wo, Wo, Wo, Wo, Wo, Ww, Gs^Fp, Gs^Fp, Gs^Fp, Gs^Fp
Mm, Mm, Mm, Mm, Mm, Mm, Hh, Hh, Rd, Rd, Rd, Rd, Hh, Gs^Fmw, Mm, Hh^Fp, Rd, Rd, Hh, Rd, Gs^Fmw, Rd, Rd, Gs^Fp, Hh, Ww, Ww, Wo, Wo, Ww, Gs^Fp, Gs^Fp, Hh
Mm, Mm, Hh^Fp, Hh^Vo, Rd, Rd, Rd, Hh, Hh^Vo, Hh, Mm, Gs^Fp, Hh^Fp, Hh^Fp, Mm, Hh, Hh, Hh, Hh, Hh^Fp, Hh^Fp, Hh, Gg^Vo, Rd, Rd, Hh, Co, Hh, Wo, Ww, Hh, Hh, Hh
Mm, Mm, Mm, Hh^Fmw, Hh^Vo, Hh^Fp, Mm, Hh, Mm, Mm, Mm, Mm, Mm, Mm, Hh, Hh, Rd, Gs^Fmw, Hh^Fp, Hh, Hh, Hh, Gg, Gg, Gg, Rd, Co, Hh, Hh, Wo, Wo, Hh, Hh
Mm, Mm, Mm, Hh, Mm, Mm, Mm, Mm, Mm, Mm, Mm, Mm, Rd, Mm, Rd, Rd, Hh^Vo, Hh, Hh, Hh, Hh^Fp, Gg^Vo, Hh, Hh, Gg^Vo, Rd, Co, 5 Ko, Co, Wo, Ww, Hh, Hh
Hh, Mm, Mm, Mm, Mm, Mm, Mm, Mm, Mm, Mm, Hh, Rd, Hh^Vo, Rd, Hh, Hh, Mm, Mm, Hh^Fp, Hh, Hh, Hh, Hh, Hh, Hh, Rd, Co, Co, Hh, Wo, Wo, Ww, Ww
Mm, Mm, Mm, Mm, Mm, Mm, Mm, Hh^Vo, Hh, Hh, Mm, Hh, Mm, Mm, Mm, Mm, Mm, Mm, Mm, Hh, Mm, Hh, Mm, Mm, Hh, Rd, Rd, Rd, Hh, Hh, Ww, Wo, Wo
Mm, Mm, Mm, Mm, Mm, Mm, Hh, Mm, Mm, Mm, Mm, Mm, Mm, Mm, Mm, Mm, Mm, Mm, Mm, Mm, Mm, Mm, Mm, Mm, Mm, Hh, Rd, Hh, Hh, Hh, Hh, Ww, Ww
