Mm, Mm, Mm, Hh, Hh, Hh, Hh, Hh, Hh, Gg, Hh, Hh, Mm, Mm, Mm, Mm, Mm, Mm, Mm, Mm, Hh, Hh, Hh^Fp, Hh^Fp, Gll^Fp, Gll^Fp, Ww, Ww, Wo, Wo, Hh, Mm, Mm
Mm, Mm, Gll^Fp, Gll^Fp, Gll^Fp, Gg, Gg, Gs, Hh, Hh^Fp, Hh, Hh, Hh, Mm, Hh, Mm, Hh, Mm, Hh, Hh, Gd^Vo, Hh, Gg, Gll^Fp, Gg, Gll^Fp, Ww, Wo, Ww, Ww, Hh, Mm, Mm
Rd, Rd, Rd, Rd, Rd, Rd, Rd, Gll^Fp, Gll^Fp, Gll^Fp, Gll^Fp, Hh, Gg, Hh, Hh, Hh, Gg, Hh, Hh, Gg, Hh, Hh, Gg, Gg, Ww, Ww, Wo, Wo, Co, Co, Co, Mm, Mm
Mm, Mm, Hh, Gg, Gll^Fp, Gg, Gg, Rd, Gll^Fp, Gll^Fp, Gg, Gg, Gg^Es, Gg, Gg, Gg, Gg, Gg, Gg, Gg, Gg, Hh, Hh, Hh, Ww, Wo, Wo, Co, Co, 3 Ko, Co, Mm, Mm
Mm, Mm, Hh, Hh, Hh^Fp, Hh, Gg, Rd, Cer, Cer, Cer, Gg, Gg, Gg, Hh, Hh, Hh, Hh, Hh, Gg, Hh, Hh, Hh, Hh, Hh, Wo, Ww, Rd, Co, Co, Re, Mm, Mm
Mm, Mm, Hh, Hh, Hh, Hh, Gg, Cer, 1 Ker, 2 Ker, Cer, Gs, Hh, Gg, Hh, Mm, Hh, Hh, Mm, Hh, Hh, Hh, Hh, Ww, Wo, Wo, Ww, Rd, Re, Re, Hh, Mm, Mm
Mm, Mm, Hh, Gg, Gg, Gg, Gg, Cer, Cer, Cer, Rd, Gg, Gg^Vo, Hh, Hh, Mm, Hh^Fp, Hh, Hh, Hh, Mm, Hh, Ww, Ww, Wo, Wo, Rd, Rd, Re, Re^Vo, Hh, Hh, Hh
Mm, Hh, Gg, Gg, Hh, Hh, Gg, Gg, Gg, Gg, Gg, Rd, Rd, Gg, Gg, Hh, Gg^Vo, Hh, Mm, Mm, Mm, Hh, Hh, Wo, Wo, Rd, Gg^Vo, Gg, Hh, Hh, Hh, Hh, Mm
Mm, Hh, Hh, Gg, Gg, Gg, Hh, Hh, Hh, Hh, Hh, Gg, Hh, Rd, Hh, Gg, Hh^Fp, Hh, Mm, Mm, Mm, Hh, Ww, Wo, Wo, Rd, Gg, Hh, Gg, Hh, Hh, Mm, Mm
Hh, Hh, Hh, Hh, Gg, Gg, Gg, Gg, Hh, Hh, Hh, Gg^Vo, Hh, Rd, Rd, Hh, Hh^Fp, Hh, Hh, Hh, Mm, Ww, Wo, Wo, Ww, Rd, Gg, Gg, Hh, Hh, Hh, Hh, Mm
Wo, Ww, Ww, Gg, Gg, Gg, Gg, Hh, Hh, Hh, Hh, Hh, Hh, Gg^Vo, Wo, Rd, Wo, Ww, Ww, Hh, Ww, Ww, Wo, Ww, Rd, Rd, Gll^Fp, Hh, Hh, Mm, Mm, Mm, Mm
Wo, Wo, Wo, Ww, Ww, Ww, Wo, Ww, Ww, Ww, Ww, Ww, Wo, Ww, Wo, Wo^Bw|, Wo, Ww, Wo, Ww, Wo, Wo, Rd, Rd, Gg, Gll^Fp, Hh, Hh, Hh, Mm, Mm, Mm, Mm
Ww, Ww, Ww, Wo, Wo, Wo, Wo, Wo, Wo, Wo, Wo, Wo, Wo, Wo, Wo, Wo^Bw|r, Wo, Wo, Wo, Wo, Wo, Wo, Wwf, Gll^Fp, Gll^Fp, Gg, Hh^Vo, Hh, Mm, Mm, Mm, Mm, Mm
Mm, Mm, Mm, Ww, Gg, Ww, Gg, Ww, Ww, Ww, Ww, Ww, Gll^Fp, Ww, Ww, Wo^Bw|, Ww, Wo, Ww, Wo, Ww, Ww, Rd, Ss, Ss, Hh^Fp, Hh, Hh^Fp, Mm, Hh, Hh, Mm, Mm
Mm, Mm, Hh, Gg, Hh, Gg, Gg, Hh, Hh, Ss, Ss, Gll^Fp, Gll^Fp, Gg, Gg^Vo, Rd, Rd, Rd, Ww, Ww, Rd, Rd, Gg, Ss, Ss, Hh^Fp, Hh, Gg, Gg, Hh, Gg, Hh^Vo, Mm
Hh, Hh, Hh, Hh, Gg, Gg, Hh, Hh, Hh, Hh, Ss, Gll^Fp, Gg, Gg, Rd, Rd, Gg, Rd, Rd, Wwf, Ss, Gg, Hh^Vo, Gg, Ss, Hh, Mm, Hh, Hh, Gg, Hh, Hh, Hh
Mm, Mm, Mm, Mm, Re^Vo, Hh, Re, Hh, Gg, Hh, Ss, Ss, Rd, Rd, Gg, Gg, Gd^Fetd, Gg, Gg^Vo, Gll^Fp, Ss, Gg, Hh, Hh, Ss, Hh, Mm, Hh, Hh^Vo, Gg, Mm, Hh, Hh
Mm, Mm, Mm, Re, Re, Hh, Re, Gg, Rd, Ss, Rd, Ss^Bw/, Ss, Gll^Fp, Gg^Vo, Gg, Gg, Gg, Gll^Fp, Gll^Fp, Ss, Ss, Ss, Hh, Hh, Ss, Mm, Mm, Mm, Mm, Hh, Hh, Hh
Hh, Hh, Mm, Re, Co, Re, Co, Rd, Ww, Rd, Wo, Ww, Gll^Fp, Gll^Fp, Gll^Fp, Gg, Gg, Gll^Fp, Ss, Gll^Fp, Ss, Hh^Fp, Hh^Fp, Ss, Mm, Mm, Mm, Mm, Mm, Mm, Hh, Hh, Hh
Hh, Hh, Hh, Co, 4 Ko, Co, Re, Rd, Ww, Wo, Wo, Wo, Wo, Gll^Fp, Gll^Fp, Gll^Fp, Gg^Vo, Gll^Fp, Ss, Ss, Hh^Fp, Hh^Fp, Mm, Ss, Mm, Mm, Mm, Mm, Mm, Mm, Gg, Hh, Hh
Hh, Hh, Hh, Co, Co, Co, Re, Rd, Rd, Wo, Wo, Wo, Wo, Wo, Wo, Gll^Fp, Gll^Fp, Gll^Fp, Ss, Hh^Fp, Hh^Fp, Mm, Mm, Mm, Hh, Mm, Hh^Vo, Hh, Mm, Hh, Gg, Hh, Hh
Mm, Hh, Hh, Hh, Hh, Hh, Hh, Re^Vo, Rd, Ww, Gg, Wo, Wo, Wo, Wo, Gll^Fp, Wo, Ww, Wo, Ss, Mm, Mm, Hh^Fp, Hh^Fp, Hh, Mm, Hh, Hh, Gg, Gg, Hh, Hh, Mm
Mm, Hh^Vo, Hh, Hh, Hh^Fp, Hh, Hh^Fp, Gll^Fp, Hh, Rd, Rd, Ww, Ww, Wo, Ww, Wo, Wo, Wo, Ww, Hh^Fp, Hh^Fp, Hh^Fp, Ww, Hh, Hh, Hh, Hh, Hh, Hh, Gg, Mm, Hh, Mm
Mm, Hh, Hh, Gg, Gg, Gg, Hh, Gll^Fp, Hh^Fp, Gg, Gg, Rd, Rd, Rd, Rd, Rd, Rd, Ww, Ww, Hh^Fp, Hh^Fp, Wo, Wo, Ww, Wo, Ww, Hh, Hh, Hh, Gg, Hh, Mm, Mm
Mm, Mm, Hh, Hh, Mm, Gg, Gg, Hh, Hh^Fp, Hh, Hh, Gg, Gll^Fp, Gll^Fp, Hh^Fp, Hh, Gg, Rd, Rd, Ww, Ww, Ww, Gll^Fp, Wo, Ww, Wo, Wo, Ww, Hh, Hh, Hh^Vo, Mm, Mm
Mm, Mm, Hh^Vo, Hh, Mm, Gg, Hh, Hh, Mm, Hh^Vo, Hh, Hh^Fp, Hh^Fp, Hh, Hh, Hh, Gg^Vo, Gg, Gll^Fp, Rd, Gg, Gll^Fp, Gll^Fp, Gll^Fp, Gll^Fp, Ww, Wo, Ww, Ww, Mm, Mm, Mm, Mm
Mm, Mm, Mm, Mm, Mm, Gg, Hh, Hh, Mm, Hh, Hh, Hh, Hh^Fp, Mm, Mm, Hh, Hh, Hh, Gll^Fp, Rd, Rd, Gll^Fp, Gll^Fp, Gll^Fp, Gll^Fp, Gll^Fp, Ww, Wo, Wo, Ww, Mm, Mm, Mm
Mm, Mm, Mm, Mm, Mm, Mm, Hh, Mm, Mm, Hh, Hh, Gg, Hh, Mm, Mm, Hh, Hh, Hh, Gll^Fp, Hh^Fp, Hh, Rd, Rd, Re, Re^Vo, Gll^Fp, Co, Co, Ww, Wo, Ww, Mm, Mm
Mm, Mm, Mm, Mm, Hh^Vo, Mm, Mm, Mm, Mm, Hh, Mm, Gg, Hh, Hh^Vo, Mm, Hh, Hh, Gll^Fp, Hh, Hh^Fp, Hh, Gll^Fp, Gll^Fp, Rd, Rd, Re, Co, Co, Co, Wo, Mm, Mm, Mm
Mm, Hh^Fp, Hh^Fp, Hh^Fp, Hh^Fp, Mm, Mm, Mm, Mm, Mm, Mm, Gg, Gg, Hh, Hh, Hh, Hh, Hh, Hh^Vo, Mm, Hh, Hh^Fp, Re, Gll^Fp, Re, Rd, Co, 5 Ko, Co, Wo, Wo, Ww, Mm
Hh^Fp, Hh^Fp, Hh^Fp, Hh^Fp, Hh^Fp, Mm, Hh^Fp, Hh^Vo, Mm, Mm, Mm, Mm, Mm, Gg, Mm, Hh, Gg, Hh, Hh, Mm, Hh, Hh^Fp, Re, Re, Re^Vo, Rd, Co, Co, Hh, Ww, Hh, Wo, Wo
Hh^Fp, Hh^Fp, Hh^Fp, Hh^Fp, Hh^Fp, Hh^Fp, Hh^Fp, Hh^Fp, Mm, Mm, Mm, Mm, Mm, Mm, Mm, Hh, Mm, Gg, Hh, Hh, Hh, Hh, Hh, Hh^Fp, Gll^Fp, Rd, Rd, Hh, Hh, Hh, Hh, Hh, Hh
Hh^Fp, Hh^Fp, Hh^Fp, Hh^Fp, Hh^Fp, Hh^Fp, Hh^Fp, Hh^Fp, Hh^Fp, Mm, Mm, Mm, Mm, Mm, Mm, Mm, Mm, Hh, Hh, Hh, Hh, Hh, Hh, Gll^Fp, Gll^Fp, Gll^Fp, Rd, Hh, Hh, Hh, Hh, Hh, Hh
