Hh, Hh, Ww, Ww, Wo, Wo, Wo, Ww, Ww, Gs^Fds, Gs^Fda, Hh, Hh, Hh, Hh, Hh, Hh, Hh, Hh, Gg, Hh, Hh, Hh, Gs^Fms, Gs^Fms, Hh, Hh, Hh, Gs^Fms, Gs^Fms, Gs^Fms, Gg, Gs^Fms
Hh, Ww, Ww, Wo, Wo, Wo, Wo, Ww, Gs^Fda, Gs^Fda, Gs^Fma, Gs, Hh, Gs, Aa, Hh, Gs, Hh, Hh, Hh, Ha, Hh, Gg, Gs^Fms, Hh, Gs^Fms, Gg, Hh, Gg, Gs^Fms, Gs^Fms, Gs^Fms, Hh
Gs^Fds, Gs^Fms, Ww, Ww, Ww, Wo, Wo, Ww, Ww, Gs, Aa, Gs, Aa, Aa, Rrc, Aa, Aa, Ha, Ha, Gs, Gs, Hh, Gg, Hh, Hh, Gg, Re^Gvs, Gs^Vc, Gg, Gg, Hh, Hh, Hh
Gs^Fms, Gs^Fms, Gs^Fms, Ww, Aa^Vca, Ww, Ww, Wo, Ww, Aa, Ms, Aa, Rrc, Rrc, Ms, Rrc, Rrc, Aa, Gs, Hh, Re^Gvs, Re^Gvs, Re^Gvs, Gg, Gg, Re^Gvs, Re^Gvs, Re^Gvs, Re^Gvs, Gg, Gs^Fms, Hh, Ww
Gg, Gg, Gg, Gg, Re^Gvs, Aa, Gs^Fma, Ww, Aa, Aa, Ms, Cha, 3 Kha, Cha, Ms, Aa, Aa, Rrc, Gs, Re^Gvs, Re^Gvs, Re^Gvs, Gg, Gg, Ds, Gg, Gg, Re^Gvs, Gg, Gg, Ww, Ww, Hh
Gg, Gg, Gg, Rb^Gvs, Gg, Gg, Gs^Fma, Ww, Aa, Ms, Ms, Cha, Cha, Cha, Ms, Ms, Aa, Rrc, Aa, Aa^Vla, Gg, Gg, Gg, Ds, Ww, Ww, Ww, Gg, Ww, Ww, Ww, Gs^Fms, Hh
Gg, Gg, Re^Gvs, Gg, Gg, Gs^Fma, Aa, Ww, Ww, Aa, Ms, Ms, Aa, Ms, Ms, Aa, Ww, Rrc, Gs, Gs, Gs, Gg, Gg^Vwm, Gg, Ww, Gg, Gg, Ww, Ww, Ds, Hh, Hh, Hh
Gg, Re^Gvs, Re^Gvs, Re^Gvs, Gs^Vh, Aa, Aa, Ds, Ww, Aa, Aa, Aa, Ww, Aa, Aa, Aa, Ww, Ww^Bsa|, Ww, Ww, Ds, Ds, Ww, Ww, Gg, Gg, Gg, Gg, Gg, Ds, Gg^Fms, Gg^Fms, Hh
Gs^Fp, Gs^Fp, Gs^Fp, Re^Gvs, Re^Gvs, Gg, Gg, Ds, Ds, Ww, Ww, Ww, Gs, Ww, Ww, Ww, Gs, Rrc, Rrc, Ww, Ww, Ww, Ww, Gg, Re^Gvs, Re^Gvs, Re^Gvs, Re^Gvs, Re^Gvs, Gg, Gg, Gg^Fms, Gg^Fms
Gs^Fp, Gs^Fp, Gg, Gg, Gg, Re^Gvs, Gg, Gg, Gg, Gs, Gs^Fpa, Gs, Gg, Gg, Re^Gvs, Re^Gvs, Re^Gvs, Gg, Gg, Rrc, Rrc, Gg, Gg^Fms, Gg^Fms, Gg, Re^Gvs, Re^Gvs, Re^Gvs, Re^Gvs, Gg, Gs^Vl, Gg^Fms, Gg^Fms
Gg, Gs^Fp, Gg, Gg, Gs^Fp, Gg, Gs^Fp, Gg, Gg^Efm, Gg, Gg, Gg, Gg, Re^Gvs, Gg, Re^Gvs, Gs^Fms, Gg, Gg, Gg, Rrc, Gg, Gg, Gg, Gg, Re^Gvs, Re^Gvs, Re^Gvs, Re^Gvs, Gg, Gg, Gg, Gg^Fms
Gg, Gg, Gs^Fp, Gs^Fp, Gg, Gs^Fp, Gs^Fp, Gg, Gg, Gg, Gg, Gg, Gg, Gg, Gg, Gs^Fms, Gs^Fp, Gg, Gs^Fms, Gg, Gg, Rrc, Rrc, Gs^Vh, Gg, Re^Gvs, Gg, Re^Gvs, Gg, Gg, Gg, Gg^Fms, Gg^Fms
Gs^Fp, Gg, Gg, Gg^Efm, Gs^Fp, Gg^Ve, Gs^Fp, Gs^Fp, Gs^Fms, Gs^Fms, Gs^Fp, Gs^Fms, Gg, Gg, Gs^Fp, Gs^Fp, Gg^Ve, Gs^Fms, Gg, Gg, Gg, Gg, Gg, Rrc, Rrc, Gg, Gs^Fms, Gg, Gg, Gg, Gg^Fms, Gg, Gg
Gs^Fp, Gs^Fp, Gg, Gs^Fp, Gs^Fp, Gs^Fp, Gs^Fms, Gs^Fms, Gg, Gs^Fp, Gs^Fp, Gg, Gs^Fp, Gg, Gg^Efm, Gg, Gg, Gg, Gg, Re, Gg, Gg, Gs^Fms, Gg, Gg, Rrc, Rrc, Gg, Gg^Efm, Gg, Gg, Gg, Gg
Gs^Fp, Gs^Fms, Gs^Fp, Gs^Fp, Gs^Fms, Gs^Fms, Gs^Fp, Gg, Gs^Fp, Gs^Fp, Gg, Gg, Gg, Gg, Gg, Gg, Gs^Fp, Gg, Gg, Re, Gg, Gs^Fp, Gs^Fms, Gs^Fp, Gg, Gg, Rrc, Gg, Gg, Gg, Gg, Gg, Gg
Gs^Fms, Gs^Fms, Gs^Fp, Gs^Fms, Gs^Fp, Gs^Fms, Gg, Gg^Ve, Gg, Gs^Fp, Gs^Fp, Gg, Gs^Fms, Gs^Fms, Gs^Fms, Gs^Fms, Gs^Fp, Gg^Ve, Gs^Fp, Re, Gs^Fp, Gs^Fms, Gs^Fms, Gg^Efm, Gs^Fms, Gs^Fms, Rrc, Gg, Gg, Gg, Gg, Gg^Efm, Gg
Gs^Fp, Gs^Fp, Gs^Fp, Gs^Fp, Gs^Fp, Gs^Fms, Gs^Fp, Gg, Gs^Fms, Gs^Fp, Gs^Fms, Gs^Fms, Gg, Gs^Fms, Gs^Fp, Gg, Re, Gs^Fp, Gg, Re, Gg, Gs^Fp, Gg^Ve, Gs^Fms, Gs^Fms, Gs^Fp, Rrc, Gg, Gs^Fms, Gg, Gg, Gg, Gg
Gs^Fp, Gs^Fp, Gs^Fp, Gg^Ve, Gs^Fp, Gs^Fms, Gs^Fp, Gg, Gs^Fms, Gs^Fms, Gg, Gg^Efm, Gs^Fms, Gs^Fms, Re, Re, Gs^Fms, Re, Re, Gg, Gs^Fp, Gs^Fp, Gs^Fms, Gs^Fp, Rrc, Rrc, Gs^Fms, Gg, Gg, Gg^Efm, Gg, Gg, Gg
Gs^Fp, Gs^Fp, Gs^Fp, Gs^Fp, Gs^Fp, Gs^Fp, Gs^Fms, Gs^Fp, Gs^Fp, Gs^Fp, Gs^Fp, Gs^Fp, Gs^Fp, Re, Gs^Fp, Gs^Fms, Gs^Fms, Gs^Fms, Re, Gg, Gs^Fp, Gs^Fms, Gs^Fp, Gs^Fp, Rrc, Gs^Fms, Gs^Fp, Gg, Gg, Gg, Gg, Gg, Ds
Gs^Fp, Gs^Fp, Gs^Fp, Gs^Fp, Gs^Fp, Gs^Fms, Gs^Fms, Gs^Fp, Gg^Efm, Gs^Fp, Gg^Ve, Gs^Fp, Gs^Fp, Gg, Gg, Gs^Fp, Gs^Fp, Gs^Fp, Re, Gs^Fp, Gg^Efm, Gg, Gg, Gg, Rrc, Gg, Gg, Gg, Ds, Ds, Ds, Ds, Wo
Gs^Fp, Gs^Fp, Gs^Fp, Gs^Fp, Gs^Fp, Gs^Fms, Gg, Gg, Gs^Fp, Gg, Gs^Fp, Gs^Fp, Gg, Gg, Ds, Gs^Fp, Gg, Re, Gg, Gg, Gg, Gg, Ww, Ww, Wo^Bsb|, Ww, Ww, Ww, Wo, Wo, Wo, Wo, Ww
Gs^Fp, Gg^Ve, Gs^Fp, Gs^Fp, Gs^Fp, Gs^Fp, Gs^Fp, Gs^Fp, Gg, Gs^Fp, Gs^Fp, Gg, Ds, Ds, Wo, Ds, Ww, Re, Ds, Ds, Ww, Ww, Wo, Wo, Rrc, Wo, Wo, Wo, Ww, Ww, Ww, Ww, Gg
Gs^Fp, Gs^Fp, Gs^Fp, Gs^Fp, Gs^Fp, Gs^Fp, Gs^Fp, Gg, Gs^Fp, Gg, Ww, Ww, Wo, Wo, Ww, Wo, Wo, Re, Wo, Wo, Wo, Wo, Ds, Ds, Rrc, Ds, Ds, Ds, Ds, Ds, Gg, Gg, Gg
Gs^Fp, Cv, Cv, Cv, Gs^Fp, Gs^Fp, Gs^Fp, Gs^Fp, Gs^Fms, Gs^Fp, Ww, Wo, Ds, Ww, Gg, Ww, Ww, Wo^Bw|, Ww, Ww, Ww, Ds, Gg, Gg, Rrc, Gg, Gg, Gg, Gg, Gg, Gg, Gs^Fds, Gg
Gs^Fp, 4 Kv, Cv, Gs^Fp, Gs^Fp, Gg^Ve, Gs^Fp, Gs^Fp, Gs^Fp, Gs^Fp, Ww, Wo, Ds, Gg, Gg^Efm, Gg, Gg, Re, Gs^Fms, Gs^Fms, Gg, Gg, Gg, Gs^Vc, Rrc, Gg, Gg, Gg, Gs^Fds, Gs^Fds, Re^Gvs, Re^Gvs, Re^Gvs
Gs^Fp, Cv, Gs^Fp, Cv, Gs^Fp, Gs^Fp, Gs^Fp, Gs^Fp, Ds, Ww, Wo, Wo, Ds, Gg, Gg, Gg, Re, Re, Re, Gg, Re, Gg, Re, Re, Gg, Rrc, Gg, Gg, Gg, Re^Gvs, Re^Gvs, Re^Gvs, Re^Gvs
Gs^Fp, Gs^Fp, Gs^Fp, Gs^Fp, Gs^Fp, Gs^Fp, Gs^Fp, Ds, Wo, Wo, Ww, Ds, Gg, Gg, Gg, Re, Gg, Gg, Gg, Re, Gg, Re, Gg, Gg, Gg, Rrc, Rrc, Gg, Gg, Re^Gvs, Gs^Vc, Re^Gvs, Re^Gvs
Gs^Fp, Gs^Fp, Gs^Fp, Gg^Ve, Gs^Fp, Gs^Fp, Ww, Ww, Wo, Ww, Gg, Gg, Gs^Vc, Gg^Efm, Gg, Re, Gg, Gg^Efm, Gg, Gg, Re^Gvs, Gg, Gg, Gg, Cer, Gg, Rrc, Cer, Cer, Gg, Gg, Re^Gvs, Re^Gvs
Gs^Fp, Gs^Fp, Ww, Gs^Fp, Ww, Ww, Wo, Wo, Ww, Ww, Gg, Gg, Gg, Gg, Re, Re, Gg, Gg^Vwm, Re^Gvs, Re^Gvs, Re^Gvs, Re^Gvs, Gg, Gg, Cer, 1 Ker, Rrc, 2 Ker, Cer, Gg^Efm, Gg, Re^Gvs, Gg
Ww, Ww, Wo, Ww, Wo, Wo, Ds, Ds, Gs^Fms, Gs^Fms, Gs^Fds, Gs^Fds, Re, Re, Gg, Gg, Gg, Gg, Gg, Re^Gvs, Gg, Gg, Gg^Efm, Gg, Gg, Cer, Gg, Rrc, Gg, Gg, Gs^Fds, Gg, Gg
Wo, Wo, Ww, Wo, Ww, Ds, Gg, Gs^Fds, Gg, Gs^Fms, Re, Re, Gg, Gg, Re^Gvs, Re^Gvs, Re^Gvs, Re^Gvs, Re^Gvs, Gg, Gg, Gg, Gg, Gg, Gg^Efm, Gg, Gg, Rrc, Gg, Gs^Fds, Gs^Fds, Gg, Gs^Fds
Ww, Ww, Ds, Ww, Gs^Fms, Ds, Gs^Fms, Gs^Vl, Re, Re, Gg, Gg, Gs^Fms, Gs^Fds, Gs^Fms, Re^Gvs, Re^Gvs, Re^Gvs, Gg, Gs^Vc, Gg, Gg, Gg, Gg, Gg, Gg, Gg, Rrc, Rrc, Gg, Gg, Gs^Fds, Gs^Fds
Ds, Ds, Gs^Fms, Gs^Fms, Gg, Gs^Fms, Gg, Gg, Re, Gg, Gg, Gs^Fms, Gs^Fds, Gs^Fds, Gs^Fds, Gs^Fds, Gs^Fds, Gs^Fds, Gg, Gg, Gg, Gg, Gg, Gg, Gg, Gg, Gg, Gg, Rrc, Gg, Gs^Fds, Gs^Fds, Gs^Fds
