Ha, Ha, Ww, Ww, Wo, Wo, Wo, Ww, Ww, Gg, Ms, Ms, Ms, Ms, Ms, Hhd, Ms, Ms, Ms, Ms, Ms, Hhd, Ms, Ms, Ms, Ha, Ha, Ha, Aa, Aa, Aa, Aa, Aa
Ha, Ww, Ww, Wo, Wo, Wo, Wo, Ww, Ms, Ms, Ms, Ms, Ms, Ms, Ha, Ms, Ha, Ms, Ha, Ha, Ha, Ms, Ms, Ms, Ha, Aa, Aa, Ha, Aa, Aa, Aa, Aa, Ha
Aa, Aa, Ww, Ww, Ww, Wo, Wo, Ww, Ww, Ha, Ha, Ms, Rrc, Rrc, Rrc, Ms, Ha, Ha, Ha, Gg, Gg, Ha, Gg, Ha, Ha, Aa, Re^Gvs, Aa^Vca, Aa, Aa, Ha, Ha, Ha
Aa, Aa, Aa, Ww, Aa^Vca, Ww, Ww, Wo, Ww, Ha, Ms, Ha, Rrc, Ha, Ms, Rrc, Rrc, Ha, Ha, Ha, Re^Gvs, Gg, Gg, Gg, Re^Gvs, Re^Gvs, Re^Gvs, Re^Gvs, Re^Gvs, Gg, Aa, Ha, Ha
Aa, Aa, Aa, Aa, Re^Gvs, Gg, Gg, Ww, Ms, Ms, Ms, Cha, 3 Kha, Cha, Ms, Ms, Ms, Rrc, Gg, Re^Gvs, Re^Gvs, Aa^Vca, Gg, Gg, Gg, Re^Gvs, Ha, Re^Gvs, Gg, Gg, Ha, Ha, Ha
Gg, Gg, Aa, Rb^Gvs, Aa, Aa, Gg, Aa, Ms, Ms, Ms, Cha, Cha, Cha, Ms, Ms, Ms, Rrc, Gg, Re^Gvs, Aa, Aa, Aa, Aa, Ha, Ha, Aa, Gg, Gg, Gg, Aa, Aa, Ha
Gg, Gg, Re^Gvs, Aa, Aa, Aa, Aa, Gg, Gg, Ms, Ms, Ha, Ha, Ha, Ms, Ms, Aa, Rrc, Gg, Gg, Gg, Aa, Gg^Vwm, Aa, Aa, Aa, Gg, Gg, Gg, Aa, Hh, Ha, Hh
Gg, Re^Gvs, Re^Gvs, Re^Gvs, Gs^Vh, Aa, Gg, Gg, Gg, Aa, Aa, Gg, Gg, Gg, Gg, Aa, Aa, Rrc, Gg, Gg, Gg, Gg, Gg, Aa, Gg, Aa, Gg, Gg, Gg, Gg, Gg, Gg, Hh
Gs^Fp, Gs^Fp, Gs^Fp, Re^Gvs, Re^Gvs, Aa, Gg, Gg, Aa, Aa, Gg, Aa, Gg, Gg, Aa, Aa, Gg, Rrc, Rrc, Gg, Gg, Gg, Gg, Gg, Re^Gvs, Re^Gvs, Re^Gvs, Re^Gvs, Re^Gvs, Gg, Aa, Gg, Aa
Gs^Fp, Gs^Fp, Gg, Gg, Gg, Re^Gvs, Gg, Gg, Gg, Gg, Gs^Fp, Gg, Gg, Gg, Re^Gvs, Re^Gvs, Re^Gvs, Gg, Gg, Rrc, Rrc, Aa, Aa, Gg, Aa, Re^Gvs, Re^Gvs, Re^Gvs, Re^Gvs, Gg, Aa^Vca, Aa, Aa
Gg, Gs^Fp, Gg, Gg, Gs^Fp, Gg, Gs^Fp, Gg, Gg^Efm, Gg, Gg, Gg, Gg, Re^Gvs, Gg, Re^Gvs, Gs^Fp, Gg, Gg, Gg, Rrc, Aa, Aa, Aa, Aa, Re^Gvs, Re^Gvs, Re^Gvs, Re^Gvs, Aa, Aa, Aa, Aa
Gg, Gg, Gs^Fp, Gs^Fp, Gg, Gs^Fp, Gs^Fp, Gg, Gg, Gg, Gg, Gg, Gg, Gg, Gg, Gs^Fp, Gs^Fp, Gg, Gs^Fp, Gg, Gg, Rrc, Rrc, Gs^Vh, Gg, Re^Gvs, Gg, Re^Gvs, Gg, Aa, Gg, Aa, Aa
Gs^Fp, Gg, Gg, Gg^Efm, Gs^Fp, Gg^Ve, Gs^Fp, Gs^Fp, Gs^Fms, Gs^Fms, Gs^Fp, Gs^Fp, Gg, Gg, Gs^Fp, Gs^Fp, Gg^Ve, Gs^Fp, Gg, Gg, Gg, Gg, Gg, Rrc, Rrc, Gg, Gs^Fp, Gg, Gg, Gg, Gg, Aa, Gg
Gs^Fp, Gs^Fp, Gg, Gs^Fp, Gs^Fp, Gs^Fp, Gs^Fms, Gs^Fms, Gg, Gs^Fp, Gs^Fp, Gg, Gs^Fp, Gg, Gg^Efm, Gg, Gg, Gg, Gg, Re, Gg, Gg, Gs^Fms, Gg, Gg, Rrc, Rrc, Gg, Gg, Aa, Gg, Gg, Gg
Gs^Fp, Gs^Fms, Gs^Fp, Gs^Fp, Gs^Fms, Gs^Fms, Gs^Fp, Gg, Gs^Fp, Gs^Fp, Gg, Gg, Gg, Gg, Gg, Gg, Gs^Fp, Gg, Gg, Re, Gg, Gs^Fp, Gs^Fms, Gs^Fp, Gg, Gg, Rrc, Gg, Gg, Gg, Gg, Gg, Gg
Gs^Fms, Gs^Fms, Gs^Fp, Gs^Fms, Gs^Fp, Gs^Fms, Gg, Gg^Ve, Gg, Gs^Fp, Gs^Fp, Gg, Gs^Fms, Gs^Fms, Gs^Fms, Gs^Fms, Gs^Fp, Gg^Ve, Gs^Fp, Re, Gs^Fp, Gs^Fms, Gs^Fms, Gg^Efm, Gs^Fms, Gs^Fp, Rrc, Gg, Gg, Gg, Gg, Gg, Gg
Gs^Fp, Gs^Fp, Gs^Fp, Gs^Fp, Gs^Fp, Gs^Fms, Gs^Fp, Gg, Gs^Fms, Gs^Fp, Gs^Fms, Gs^Fms, Gg, Gs^Fms, Gs^Fp, Gg, Re, Gs^Fp, Gg, Re, Gg, Gs^Fp, Gg^Ve, Gs^Fms, Gs^Fms, Gs^Fp, Rrc, Gg, Gs^Fp, Gg, Gg, Gg, Gg
Gs^Fp, Gs^Fp, Gs^Fp, Gg^Ve, Gs^Fp, Gs^Fms, Gs^Fp, Gg, Gs^Fms, Gs^Fms, Gg, Gg^Efm, Gs^Fms, Gs^Fms, Re, Re, Gs^Fms, Re, Re, Gg, Gs^Fp, Gs^Fp, Gs^Fms, Gs^Fp, Rrc, Rrc, Gs^Fms, Gg, Gg, Gg, Gg, Gg, Gg
Gs^Fp, Gs^Fp, Gs^Fp, Gs^Fp, Gs^Fp, Gs^Fp, Gs^Fms, Gs^Fp, Gs^Fp, Gs^Fp, Gs^Fp, Gs^Fp, Gs^Fp, Re, Gs^Fp, Gs^Fms, Gs^Fms, Gs^Fms, Re, Gg, Gs^Fp, Gs^Fms, Gs^Fp, Gs^Fp, Rrc, Gs^Fms, Gs^Fp, Gg, Gg, Gg, Gg, Gg, Ds
Gs^Fp, Gs^Fp, Gs^Fp, Gs^Fp, Gs^Fp, Gs^Fms, Gs^Fms, Gs^Fp, Gg^Efm, Gs^Fp, Gg^Ve, Gs^Fp, Gs^Fp, Gg, Gg, Gs^Fp, Gs^Fp, Gs^Fp, Re, Gs^Fp, Gg^Efm, Gg, Gg, Gg, Rrc, Gg, Gg, Gg, Ds, Ds, Ds, Ds, Wo
Gs^Fp, Gs^Fp, Gs^Fp, Gs^Fp, Gs^Fp, Gs^Fms, Gg, Gg, Gs^Fp, Gg, Gs^Fp, Gs^Fp, Gg, Gg, Ds, Gs^Fp, Gg, Re, Gg, Gg, Gg, Gg, Ww, Ww, Wo^Bw|, Ww, Ww, Ww, Wo, Wo, Wo, Wo, Ww
Gs^Fp, Gg^Ve, Gs^Fp, Gs^Fp, Gs^Fp, Gs^Fp, Gs^Fp, Gs^Fp, Gg, Gs^Fp, Gs^Fp, Gg, Ds, Ds, Wo, Ds, Ww, Re, Ds, Ds, Ww, Ww, Wo, Wo, Rrc, Wo, Wo, Wo, Ww, Ww, Ww, Ww, Gs^Fms
Gs^Fp, Gs^Fp, Gs^Fp, Gs^Fp, Gs^Fp, Gs^Fp, Gs^Fp, Gg, Gs^Fp, Gg, Ww, Ww, Wo, Wo, Ww, Wo, Wo, Re, Wo, Wo, Wo, Wo, Ds, Ds, Rrc, Ds, Ds, Ds, Gs^Fms, Gs^Fms, Gs^Fms, Gs^Fms, Gs^Fms
Gs^Fp, Cv, Cv, Cv, Gs^Fp, Gs^Fp, Gs^Fp, Gs^Fp, Gs^Fms, Gs^Fp, Ww, Wo, Ds, Ww, Gs^Fms, Ww, Ww, Wo^Bw|, Ww, Ww, Ww, Ds, Gg, Gg, Rrc, Gg, Gg, Gs^Fms, Gg, Gs^Fms, Gg, Gg, Gs^Fms
Gs^Fp, 4 Kv, Cv, Gs^Fp, Gs^Fp, Gg^Ve, Gs^Fp, Gs^Fp, Gs^Fp, Gs^Fp, Ww, Wo, Ds, Gs^Fms, Gs^Fms, Gs^Fms, Gs^Fms, Re, Gs^Fms, Gs^Fms, Gg, Gg, Gg, Gs^Vc, Rrc, Gg, Gg, Gg, Gs^Fms, Gs^Fms, Re^Gvs, Re^Gvs, Re^Gvs
Gs^Fp, Cv, Gs^Fp, Cv, Gs^Fp, Gs^Fp, Gs^Fp, Gs^Fp, Ds, Ww, Wo, Wo, Ds, Gs^Fms, Gg, Gg, Re, Re, Re, Gg, Re, Gg, Re, Re, Gg, Rrc, Gg, Gg, Gg, Re^Gvs, Re^Gvs, Re^Gvs, Re^Gvs
Gs^Fp, Gs^Fp, Gs^Fp, Gs^Fp, Gs^Fp, Gs^Fp, Gs^Fp, Ds, Wo, Wo, Ww, Ds, Gg, Gs^Fms, Gg, Re, Gg, Gg, Gg, Re, Gg, Re, Gg, Gg, Gg, Rrc, Cer, Gg, Gg, Re^Gvs, Gs^Vc, Re^Gvs, Re^Gvs
Gs^Fp, Gs^Fp, Gs^Fp, Gg^Ve, Gs^Fp, Gs^Fp, Ww, Ww, Wo, Ww, Gg, Gg, Gs^Vc, Gg, Gg, Re, Gg, Gg, Gg, Gg, Re^Gvs, Gg, Gg, Gg, Cer, Cer, 2 Ker, Cer, Gg, Gg, Gg, Re^Gvs, Re^Gvs
Gs^Fp, Gs^Fp, Ww, Gs^Fp, Ww, Ww, Wo, Wo, Ww, Ww, Gg, Gg, Gg, Gg, Re, Re, Gg, Gg^Vwm, Re^Gvs, Re^Gvs, Re^Gvs, Re^Gvs, Gg, Gg, Cer, 1 Ker, Cer, Cer, Gg, Gg, Gg, Re^Gvs, Gg
Ww, Ww, Wo, Ww, Wo, Wo, Ds, Ds, Gs^Fms, Gs^Fms, Gs^Fms, Gs^Fms, Re, Re, Gg, Gg, Gg, Gg, Gg, Re^Gvs, Gg, Gg, Gg, Gg, Gg, Cer, Gg, Rrc, Gg, Gg, Gs^Fms, Gg, Gg
Wo, Wo, Ww, Wo, Ww, Ds, Gg, Gg, Gg, Gs^Fms, Re, Re, Gg, Gg, Re^Gvs, Re^Gvs, Re^Gvs, Re^Gvs, Re^Gvs, Gg, Gg, Gg, Gg, Gg, Gg, Gg, Gg, Rrc, Gg, Gs^Fms, Gg, Gg, Gg
Ww, Ww, Ds, Ww, Gs^Fms, Ds, Gs^Fms, Gs^Vc, Re, Re, Gg, Gg, Gs^Fms, Gs^Fms, Gs^Fms, Re^Gvs, Re^Gvs, Re^Gvs, Gg, Gs^Vc, Gg, Gg, Gg, Gg, Gg, Gg, Gg, Rrc, Rrc, Gg, Gg, Gg, Gg
Ds, Ds, Gs^Fms, Gs^Fms, Gg, Gs^Fms, Gg, Gg, Re, Gg, Gg, Gs^Fms, Gs^Fms, Gs^Fms, Gg, Gs^Fms, Gg, Gg, Gg, Gg, Gg, Gg, Gg, Gg, Gg, Gg, Gg, Gg, Rrc, Gg, Gg, Gg, Gg
