Cte, Cte, Cte, Mm, Mm, Mm, Mm, Mm, Mm, Hh, Hh, Gs^Fms, Gs^Fms, Gs^Fms, Hh, Hh, Hh, Hh, Hh, Hh, Gg, Gg, Gg, Gg, Rr, Rr
Cte, 5 Kte, Cte, Cte, Mm, Mm, Mm, Mm, Mm, Hh, Hh^Fms, Gs^Fms, Gs^Fds, Gs^Fms, Hh^Fms, Hh, Hh, Hh, Hh, Gg, Gg, Gg, Rr, Rr, Gg, Gg
Mm, Cte, Mm, Mm, Hh, Hh, Hh, Hh, Hh, Hh, Hh^Fms, Gs^Fms, Gs^Fds, Gs^Fms, Hh, Hh, Hh, Gs^Vh, Gg, Gg, Rr, Rr, Gg, Gs^Vh, Gg, Gg
Hh, Hh, Hh, Hh, Hh, Hh, Ww, Gs^Fms, Hh^Fms, Hh, Hh, Hh, Gg, Hh, Gg, Gg, Gg, Gg, Gg, Gg, Rr, Gg, Gg, Gg, Gg, Gg
Hh, Hh, Ww, Ww, Ww, Ww, Gs^Fms, Gs^Fms, Gs^Fds, Gs^Fds, Gs^Fds, Gs^Fms, Gs^Fms, Gg, Gg, Gg, Gg^Es, Gg^Es, Rr, Rr, Gg, Gg, Gg, Gg, Gg, Gg
Mm, Mm, Hh, Ww, Ww, Ww, Gs^Fms, Gs^Fms, Gs^Fds, Gs^Fds, Gs^Fms, Gs^Fds, Gg, Gg, Gg, Gg, Gg, Gg, Rr, Gg, Gs^Fds, Gs^Fds, Gs^Vh, Gs^Fds, Gs^Fds, Gs^Fms
Mm, Mm, Hh, Hh, Ww, Ww, Ww, Gs^Fms, Gs^Fms, Gs^Fms, Gs^Fms, Gs^Vh, Gg, Gg, Hh, Gg, Gg, Gs^Vh, Rr, Gg, Gs^Fds, Gs^Fms, Gs^Fds, Gs^Fds, Gs^Fms, Gs^Fds
Mm, Mm, Mm, Hh, Ww, Ww, Ds, Ds, Gs^Fms, Gg, Gg, Gg, Gg, Gg, Hh, Gg, Gg, Gg, Rr, Gg, Gs^Fms, Gs^Fds, Gs^Fds, Gs^Fds, Gs^Fms, Gs^Fds
Mm, Mm, Mm, Mm, Hh, Hh, Gg, Gg, Gg, Gg, Gg, Gg, Gg^Es, Mm, Hh, Hh, Gg, Gg, Gg, Rr, Rr, Gs^Fms, Gs^Fms, Gs^Fms, Gs^Fms, Gs^Fds
Hh, Hh, Mm, Hh, Mm, Hh, Hh, Gg, Gg, Gg, Hh, Hh, Gg, Mm, Mm, Hh, Hh, Gg, Hh, Gg, Rr, Gs^Fms, Gs^Fms, Gs^Fms, Gg, Gg
Hh, Hh, Mm, Hh, Hh, Gs^Fp, Gg, Gs^Vh, Gg, Gg, Hh, Hh, Mm, Mm, Mm, Hh, Hh, Gs^Vc, Hh, Gg, Rr, Gg, Gg, Gg, Gg, Gg
Hh, Hh, Hh, Gs^Fp, Gs^Fp, Gs^Fp, Gg^Es, Gg, Gg, Hh, Hh, Mm, Mm, Mm, Mm, Mm, Hh, Hh, Hh, Gg, Gg, Rr, Gg, Gg^Es, Gg, Gg
Hh, Hh, Gs^Fp, Gs^Vh, Gg, Gg, Gg, Gg, Hh^Vhh, Hh, Mm, Mm, Mm, Mm, Mm, Mm, Mm, Hh, Hh, Hh, Gg, Rr, Gs^Vh, Gg, Gg, Gg
Mm, Hh, Hh, Mm, Gg, Gg, Gs^Fp, Gs^Fp, Hh, Mm, Mm, Mm, Hh, Hh, Mm, Mm, Mm, Hh, Hh, Hh, Gg, Rr, Gg, Gg, Gg, Gg
Mm, Hh, Mm, Mm, Gs^Fp, Hh, Gs^Fp, Gs^Fp, Hh, Mm, Mm, Hh, Hh, Hh, Hh, Mm, Mm, Mm, Hh, Hh, Gg, Rr, Gg, Ss, Gg, Gg
Mm, Hh^Vhh, Mm, Mm, Gs^Fp, Hh, Mm, Hh, Mm, Mm, Hh, Hh, Mm, Mm^Ii, Mm, Hh, Mm, Mm, Hh, Hh, Gg, Rr, Gg, Ss, Gg, Gg
Mm, Mm, Mm, Mm, Hh, Mm, Mm, Mm, Mm, Mm, Hh, Hh, Mm, Mm, Mm, Hh, Hh, Hh, Mm, Hh, Gg, Rr, Rr, Gg, Gg, Gg
Mm, Mm, Mm, Hh, Hh, Hh, Mm, Mm, Mm, Mm, Hh, Ww, Hh, Mm, Hh, Hh, Mm, Mm, Mm, Hh, Gs^Vc, Gg, Gg, Rr, Ss, Gg
Mm, Mm, Hh, Hh, Hh, Hh, Hh, Mm, Mm, Mm, Hh, Hh, Mm, 4 Kte, Mm, Mm, Mm, Mm, Mm, Mm, Hh, Hh, Gg, Rr, Gg, Ss
Gs^Fms, Gs^Fms, Gs^Fms, Hh, Gs^Vc, Hh, Hh, Hh, Mm, Mm, Mm, Hh, Hh, Cte, Hh, Mm, Mm, Hh, Mm, Mm, Mm, Hh, Gg, Rr, Gg, Ss
Gs^Fms, Gs^Fms, Gs^Fms, Gs^Fms, Gg, Hh, Hh, Hh, Mm, Mm, Mm, Mm, Hh, Hh, Hh, Mm, Mm, Hh, Hh, Mm, Hh, Mm, Gs^Vh, Rr, Gg, Gg
Gs^Fms, Gs^Fms, Gg, Gg, Gs^Fms, Hh, Hh^Fms, Hh, Hh, Hh, Mm, Mm, Hh, Hh, Mm, Mm, Mm, Hh, Hh, Hh, Ss, Hh, Ss, Rr, Ss, Gg
Gs^Fms, Gs^Fms, Gg, Gg, Hh, Hh, Gs^Fms, Hh^Fms, Hh, Hh, Mm, Mm, Mm, Mm, Mm, Mm, Hh, Hh, Hh, Hh, Ss, Ss, Rr, Rr, Ss, Hh
Gs^Fms, Gs^Fms, Gs^Fms, Gg^Es, Gs^Fms, Gs^Fms, Gs^Fms, Gs^Fms, Gs^Fms, Hh, Hh^Fms, Mm, Mm, Mm, Mm, Hh, Hh, Hh, Hh^Fms, Hh, Ss, Ss, Rr, Ss, Hh, Hh
Gs^Fms, Gs^Fms, Gs^Fms, Gs^Vc, Gs^Fms, Hh, Hh, Gs^Fms, Gs^Fms, Hh^Fms, Gs^Fms, Hh, Mm, Mm, Hh, Hh, Hh^Fms, Gs^Fms, Hh^Fms, Hh, Rr, Rr, Ss, Ss, Hh, Hh
Gs^Fms, Gs^Fms, Gs^Fms, Gg, Gg, Gs^Fms, Gs^Fms, Hh, Gs^Fms, Gs^Fms, Hh, Hh^Fms, Hh, Mm, Hh, Hh^Fms, Gs^Fms, Gs^Fms, Gs^Fms, Gg^Es, Rr, Ss, Hh, Ss, Hh, Hh
Gs^Fms, Gs^Fms, Gs^Fms, Gg, Gs^Fms, Gg, Gg, Gg, Gs^Vc, Hh, Hh, Gs^Fms, Gs^Fms, Hh, Hh^Fms, Gs^Fms, Hh, Hh, Gs^Fms, Gg, Rr, Gs^Vh, Hh, Hh, Mm, Mm
Gs^Fms, Gs^Fms, Gs^Fms, Gg, Gg, Gs^Fms, Gs^Fms, Gg, Gs^Fms, Hh, Gs^Fms, Hh, Hh^Fms, Gs^Fms, Hh^Fms, Gs^Fms, Gg, Hh, Rr, Rr, Gg, Hh, Hh, Mm, Mm, Mm
Gs^Fms, Gs^Fms, Gs^Vc, Gs^Fms, Gs^Fms, Gs^Fms, Gs^Fms, Gg, Gg, Gs^Fms, Hh, Hh^Fms, Hh, Gs^Fms, Gs^Fms, Gg, Rr, Rr, Gg, Gg, Gg, Hh, Mm, Mm, Mm, Mm
Gs^Fms, Gs^Fms, Gg, Gs^Fms, Gs^Fms, Gs^Fms, Gs^Fms, Gs^Fms, Gs^Fms, Gg, Rr, Rr, Rr, Gs^Fms, Rr, Rr, Gs^Fms, Gs^Vc, Hh, Mm, Mm, Hh, Hh, Mm, Mm, Mm
Gg, Gg, Gg, Gs^Fms, Gg, Gs^Fms, Gs^Fms, Gg, Gg, Rr, Gg, Gs^Fms, Gs^Fms, Rr, Gs^Fms, Gg, Gs^Fms, Hh, Hh, Mm, Mm, Mm, Hh, Mm, Hh, Hh
Gg, Gg, Gg, Gg^Efm, Gg, Gg, Gg, Gg, Gg, Rr, Gg, Gs^Fms, Gs^Fms, Gs^Fms, Gs^Fms, Gg, Hh, Hh, Gs^Fms, Mm, Mm, Mm, Hh, Hh, Hh, Hh
Gg, Gg, Gg, Gg, Gs^Vh, Gs^Fms, Gg, Gg, Gg, Rr, Gg, Gs^Fms, Gs^Fms, Gs^Fms, Gs^Fms, Gs^Fms, Hh, Hh, Gs^Fms, Hh, Mm, Mm, Hh, Hh^Vhh, Hh, Hh
Gg, Gg^Efm, Gg, Gg, Gs^Fms, Gs^Fms, Gs^Fms, Gg, Gg, Rr, Gs^Vh, Gs^Fms, Gs^Fms, Gs^Fds, Gg, Gs^Vc, Gs^Fms, Gs^Fds, Gs^Fms, Gs^Fms, Hh, Gs^Fms, Hh, Hh, Hh, Hh
Gg, Gg, Gg, Gg, Gg, Gs^Fds, Gs^Fds, Gg, Gg, Rr, Gg, Gg, Gs^Fms, Gs^Fds, Gg, Gg^Efm, Gs^Fds, Gs^Fds, Gs^Fds, Gs^Fms, Gs^Fms, Gs^Fms, Hh, Hh, Hh, Hh
Gg, Gg, Gg, Gg^Efm, Gg, Gs^Fds, Gg, Gg, Rr, Rr, Gg, Gg, Gg, Gs^Fms, Gg, Gg, Gg, Gg, Gg, Gs^Vc, Gs^Fds, Gs^Fds, Gs^Fms, Hh, Hh, Hh
Gg, Gg, Gg, Gg, Gg, Gg, Rr, Rr, Gg, Gg, Gg^Efm, Gg, Gg, Gg, Gs^Fms, Gg, Gg^Efm, Gg, Gs^Fds, Gg, Gs^Fms, Gs^Fms, Hh, Hh, Hh, Hh
Gg, Gg, Cer, Cer, Cer, Rr, Cer, Gg, Gg, Gg, Gg, Gg, Gg, Gg^Efm, Gs^Fms, Gs^Fms, Gs^Fms, Gs^Fms, Gs^Fds, Gs^Fms, Hh, Gs^Fms, Gs^Vh, Mm, Cte, Mm
Gg, Gg, Gg, 1 Ker, Rr, Rr, 2 Ker, Cer, Gg, Gg, Gg, Gg, Gg, Gg, Gg, Gs^Fms, Gs^Fds, Gs^Fds, Gs^Fds, Gs^Fms, Hh, Mm, Mm, Mm, Cte, Cte
Gg, Gg, Gg, Rr, Gg, Gg, Gg, Cer, Gg, Gg, Gg^Efm, Gg, Gs^Fms, Gs^Vh, Gs^Fms, Gs^Fds, Gs^Fds, Gs^Fds, Gs^Fms, Hh, Hh, Mm, Mm, Cte, 3 Kte, Cte
Gg, Gg, Gg, Rr, Gg, Gg, Gg, Gg, Gg, Gg, Gg, Gg, Gs^Fms, Gs^Fms, Gs^Fms, Gs^Fds, Gs^Fds, Gs^Fds, Hh, Hh, Hh, Mm, Mm, Cte, Cte, Cte
