Hhd, Hhd, Hhd, Mm, Mm, Mm, Hhd, Mm, Mm, Mm, Mm, Mm, Mm, Mm, Mm, Mm, Mm, Mm, Mm, Mm, Mm, Mm, Mm, Mm, Mm, Mm, Mm, Mm, Mm, Mm, Mm, Mm, Mm, Mm, Mm, Mm, Mm, Mm, Mm, Mm, Hhd, Mm, Rd
Hh, Hh, Hh, Hh, Hh, Hhd, Hh, Hhd, Mm, Mm, Mm, Mm, Mm, Mm, Mm, Mm, Mm, Mm, Mm, Mm, Mm, Mm, Mm, Mm, Mm, Mm, Mm, Mm, Mm, Mm, Mm, Mm, Mm, Mm, Mm, Mm, Mm, Mm, Mm, Hhd, Rd, Rd, Hhd
Gg, Hh, Gg, Hh, Hh, Hhd, Hh, Hhd, Hh, Mm, Hh, Mm, Mm, Mm, Mm, Mm, Mm, Mm, Mm, Mm, Mm, Mm, Mm, Mm, Mm, Mm, Mm, Mm, Mm, Mm, Mm, Mm, Mm, Mm, Mm, Mm, Mm, Mm, Mm, Rd, Mm, Mm, Mm
Gg, Gg, Hh, Gg, Gg, Hh, Gg, Hh, Re, Hh, Hh, Mm, Mm, Mm, Mm, Hh, Hhd, Mm, Mm, Mm, Mm, Mm, Mm, Mm, Mm, Mm, Mm, Mm, Mm, Mm, Mm, Mm, Mm, Mm, Mm, Mm, Hhd, Hhd, Rd, Rd, Mm, Mm, Mm
Gg, Gg, Gg, Hh, Hh, Gg, Gg, Gg, Re, Hh, Hh, Hhd, Hhd, Mm, Hh, Hh^Vhh, Hh, Hhd, Mm, Mm, Mm, Mm, Mm, Mm, Mm, Mm, Mm, Mm, Mm, Mm, Mm, Mm, Mm, Mm, Mm, Mm, Rd, Rd, Mm, Mm, Mm, Mm, Mm
Rd, Gg, Gg, Hh, Hh, Gg, Re^Es, Gg, Cer, Cer, Cer, Hh, Hh, Hh, Hh, Hh, Hh, Hhd, Hhd, Hhd, Hhd, Mm, Mm, Mm, Mm, Mm, Mm, Mm, Mm, Mm, Mm, Mm, Mm, Mm, Mm, Mm, Rd, Hhd, Mm, Mm, Mm, Mm, Mm
Gg, Rd, Rd, Gg, Gg, Gg, Cer, Re, Re, 2 Ker, Cer, Re, Hh, Hh^Fp, Hh, Hh, Hh, Mm, Mm, Hhd, Hhd, Mm, Mm, Mm, Mm, Mm, Mm, Mm, Mm, Mm, Mm, Mm, Mm, Mm, Hhd, Mm, Rd, Hhd, Hhd, Mm, Mm, Mm, Mm
Gg, Gg, Gg, Rd, Gg, Gg, Cer, 1 Ker, Cer, Re, Re^Es, Gg, Gg, Hh, Gll^Fmw, Hh^Fp, Hh, Mm, Mm, Mm, Mm, Hh, Hh, Hh^Vhh, Mm, Mm, Mm, Mm, Mm, Mm, Mm, Mm, Mm, Mm, Hhd, Rd, Mm, Mm, Mm, Mm, Mm, Mm, Mm
Gg, Gg^Efm, Gg, Rd, Rd, Re, Re, Cer, Re, Re, Gg, Gg, Gg, Gg, Gg, Gll^Fp, Mm, Mm, Hhd, Mm, Mm, Hh, Hhd, Hh, Mm, Mm, Mm, Hhd, Hhd, Mm, Mm, Mm, Mm, Mm, Mm, Rd, Hhd, Mm, Mm, Mm, Mm, Mm, Mm
Gg, Gg, Gg, Gg, Gg, Rd, Rd, Re^Es, Re, Gg, Re^Gvs, Gs^Vc, Re^Gvs, Gg, Gg, Gll^Fp, Gll^Fp, Mm, Hh, Hhd, Hhd, Hhd, Mm, Hh, Mm, Mm, Mm, Hhd, Hhd, Hh, Hh, Hh, Hh, Mm, Mm, Mm, Rd, Mm, Mm, Mm, Mm, Mm, Mm
Gg, Gg, Gg, Gg, Gg^Efm, Gg, Rd, Gg, Gg, Gg, Re^Gvs, Re^Gvs, Gg, Gg, Hh, Gg, Gg, Gg, Gg, Hh, Hh^Fp, Mm, Hh, Mm, Mm, Mm, Mm, Mm, Hhd, Mm, Mm, Hh, Hh, Hh^Vhh, Hh, Hh, Rd, Hh, Hh, Mm, Mm, Mm, Mm
Gg^Efm, Gg^Efm, Gg, Gg, Gg, Gg, Gg, Rd, Rd, Gg, Gg, Gg, Gg, Hh, Hh, Hh, Gg, Gg, Gg, Hh, Gll^Fp, Hh, Hh, Hh, Hh, Mm, Mm, Mm, Hhd, Hh, Mm, Mm, Mm, Hh, Hh, Hh, Rd, Hh, Hh, Hh^Vhh, Mm, Mm, Mm
Gg, Gg, Gg, Gll^Fp, Gll^Fp, Gg, Re^Gvs, Gs^Vc, Gg, Rd, Gg, Gg, Gg, Gg, Hh, Hh^Fp, Hh, Hh, Gg, Gll^Fp, Gll^Fmw, Hh, Hh^Fp, Mm, Mm, Hh, Hh, Mm, Hh, Hh, Hh, Mm, Hh, Hh, Rd, Rd, Hh, Hh, Hh, Hhd, Hhd, Mm, Hh
Gll^Fp, Gll^Fp, Gll^Fp, Gg, Gll^Fp, Gg, Re^Gvs, Re^Gvs, Gg, Rd, Gg, Gg^Efm, Gg, Hh, Gg, Hh, Gg, Hh, Gg, Gg, Gll^Fp, Hh, Gg, Hh, Hh^Fp, Hh, Gg, Hh, Hh, Hh, Hh, Hh, Hh, Rd, Mm, Hh, Hh, Hh, Mm, Hhd, Hhd, Mm, Hh
Gll^Fp, Gll^Fp, Gll^Fp, Gll^Fp, Gll^Fp, Gll^Fp, Gg, Re^Gvs, Gg, Rd, Rd, Gg, Gg, Re^Gvs, Re^Gvs, Gg, Gll^Fp, Hh, Gg, Gg, Gg, Gg, Hh, Gll^Fmw, Gll^Fp, Hh, Gg, Gg^Es, Rd, Rd, Rd, Rd, Rd, Rd, Gll^Fp, Mm, Mm, Mm, Mm, Mm, Hhd, Hh, Hh
Gg, Gll^Fp, Gll^Fp, Gg^Ve, Gg, Gll^Fp, Gll^Fp, Gg, Gll^Fp, Gg, Gg, Rd, Gs^Vc, Re^Gvs, Re^Gvs, Hh, Hh^Fmw, Gll^Fp, Gg, Gg, Hh, Gg, Rd, Rd, Rd, Gg, Rd, Rd, Gg, Hh, Hh, Hh, Hh, Gll^Fp, Gll^Fmw, Gll^Fp, Hh, Mm, Mm, Mm, Hhd, Hh, Hh
Gg, Gg, Gll^Fp, Gg, Gll^Fp, Gg, Gg, Gg, Gg, Gg, Gg, Rd, Rd, Gg, Re^Gvs, Hh, Hh, Hhd, Hh, Hhd, Gg, Gg, Rd, Hh, Hh, Rd, Hh, Gg, Hh, Gg, Hh, Hh^Fmw, Gll^Fmw, Hh, Gll^Fp, Hh, Hh, Hh, Mm, Mm, Mm, Mm, Hh
Gg, Gg, Gg, Gg^Efm, Gg, Gll^Fp, Gg, Gg^Efm, Gg, Gg, Gg, Gg, Rd, Gg, Gg, Gll^Fp, Hh, Hhd, Hhd, Hh, Hh, Gg, Rd, Gs^Vc, Gg, Hh, Hhd, Hh, Hh, Gg, Hh, Gll^Fp, Hh, Gg, Gg^Es, Gll^Fp, Hh, Hh^Vhh, Hh^Fp, Mm, Mm, Hh, Hh
Gs^Fms, Gg, Gg, Gg, Gg, Gg, Gg, Gg, Gg, Gg, Gg, Gg, Rd, Gg, Gg, Gll^Fp, Gg, Gs^Vc, Re^Gvs, Hh, Hh, Gg, Rd, Rd, Rd, Gg, Hh, Hhd, Hh, Gg, Hhd, Hhd, Hh^Fp, Gg, Gg, Hh, Hh^Fp, Hh, Hhd, Hhd, Hhd, Hh, Hh
Gs^Fms, Gs^Fms, Gs^Fms, Gs^Fms, Gs^Fms, Gg, Gs^Fms, Gs^Fms, Gs^Fms, Gs^Fms, Gg, Gg, Gg, Rd, Gg, Gg, Gg, Re^Gvs, Re^Gvs, Re^Gvs, Gg, Gg, Rd, Ch, Rd, Gg, Gg, Gs^Vc, Hh, Hh^Fp, Gll^Fmw, Hhd, Hh, Hh, Hh, Hh, Gg, Hh, Gll^Fmw, Hh^Fp, Hhd, Hhd, Hh
Gs^Fms, Gs^Fmw, Gs^Fms, Gs^Fms, Gs^Fms, Gs^Fms, Gs^Fds, Gs^Fms, Gs^Fms, Gs^Fms, Gg, Gg, Gg, Rd, Rd, Gg, Rd, Gg, Gg, Gg, Rd, Rd, Ch, Ch, Ch, Rd, Gg, Re^Gvs, Re^Gvs, Hh, Gll^Fp, Gll^Fp, Hh, Gg, Gg, Hh, Hh, Gg, Hh, Gll^Fp, Gll^Fmw, Hh, Hh
Gg, Gs^Fds, Gs^Fds, Gg^Ve, Gs^Fms, Gg, Gg, Gs^Fms, Gs^Fms, Gg, Gs^Fms, Gs^Fms, Gg, Gg, Gg, Rd, Gg, Rd, Rd, Rd, Gg, Ch, Ch, 3 Kh, Ch, Rd, Rd, Gg, Gg, Gg, Gll^Fp, Hh, Gg, Hh, Gg, Gg, Gg, Gg, Gg, Hh, Hh^Fp, Hh, Hh
Gg, Gg, Gs^Fms, Gs^Fms, Gs^Fms, Gs^Fds, Gs^Fds, Gg, Gg^Efm, Gg, Gg, Gg, Gg, Gg, Gg, Gg, Gs^Fms, Gs^Fms, Gg, Gs^Vc, Re^Gvs, Gg, Gg, Ch, Gg, Gg, Gg^Es, Rd, Rd, Gg, Gg, Gg, Re^Gvs, Hh, Hh, Gg, Gg, Hh, Hh^Vhh, Hh, Hh, Hh, Hh
Gg, Gg, Gg, Gg, Gs^Fds, Gg, Gg, Gg, Gg, Gg, Gs^Fds, Gg, Gg, Gg, Gg^Efm, Gg, Gg, Gs^Fms, Gg, Re^Gvs, Re^Gvs, Re^Gvs, Re^Gvs, Gg, Gs^Fms, Gg, Gg, Hh, Hh, Rd, Rd, Gg, Re^Gvs, Gs^Vc, Gg, Gg, Hh, Hh, Hh, Hh, Hh, Gg, Hh
Gs^Fds, Gg, Gs^Fds, Gg, Gg, Gs^Fms, Gg, Gs^Fms, Gs^Fms, Gg, Gg, Gg, Gg, Gg, Gg, Gg, Gg, Gg, Gg^Efm, Gg, Gg, Gs^Fms, Gg, Gg, Gs^Fms, Gs^Fms, Gs^Fms, Hh^Fms, Hhd, Hh, Rd, Gg, Gg, Re^Gvs, Gg, Gg, Gg, Hh, Hh, Hh, Gg, Gg, Hh
Gs^Fms, Gs^Fds, Gg, Gs^Fms, Gs^Fms, Gg, Gg, Gs^Fds, Gs^Fds, Gs^Fms, Gs^Fds, Gs^Fds, Gs^Fms, Gs^Fms, Gs^Fds, Gg, Gg, Gg, Gg, Gg, Gg, Gs^Fms, Gs^Fms, Hh, Hh, Hh, Hh, Hhd, Hh, Hh, Gg, Rd, Gg, Gg, Gg, Gg, Hh, Gg, Hh, Hh, Hh, Gg, Gg
Gs^Fms, Gs^Fms, Gs^Fds, Gs^Fms, Gs^Fds, Gs^Fms, Gs^Fds, Gg, Gg^Ve, Gs^Fds, Gs^Fds, Gs^Fds, Gs^Fds, Gg, Gs^Fds, Gg, Gg, Gg, Gg, Gg, Gg, Gg, Gs^Fms, Gs^Fms, Hh, Hh^Fms, Hh, Gs^Fms, Gs^Fms, Gg, Gg, Rd, Rd, Gg^Es, Gg, Gg, Hh, Hh, Re^Gvs, Gs^Vh, Hh, Hh, Gg
Gs^Fds, Gs^Fms, Gs^Fds, Gs^Fds, Gs^Fmw, Gs^Fms, Gs^Fds, Gg, Gs^Fds, Gs^Fms, Gs^Fms, Gs^Fmw, Gs^Fds, Gs^Fds, Gs^Fds, Gs^Fds, Gs^Fds, Re^Gvs, Re^Gvs, Re^Gvs, Re^Gvs, Gg, Gg, Gs^Fms, Gg, Gll^Fp, Gs^Vl, Hh, Gs^Fms, Gs^Fms, Hh, Gg, Gg, Rd, Rd, Gg, Gg, Re^Gvs, Re^Gvs, Re^Gvs, Gg, Gg, Gg
Gg, Gg, Gs^Fds, Gg^Ve, Gg, Gs^Fms, Gs^Fds, Gs^Fds, Gs^Fds, Gs^Fms, Gs^Fms, Gs^Fds, Gg^Ve, Gg, Gs^Fds, Gg, Gg, Gg, Gs^Vh, Re^Gvs, Gg, Gg, Gg, Gg, Gg^Efm, Gg, Gg, Hh^Fms, Gs^Fms, Gs^Fms, Gs^Fms, Gs^Fms, Re^Gvs, Gg, Gg, Rd, Rd, Gg, Gg, Gg, 4 Gg, Gg, Gg
Gs^Fds, Gs^Fds, Gs^Fds, Gs^Fms, Gs^Fms, Gs^Fms, Gs^Fms, Gg^Fet, Gs^Fds, Gs^Fms, Gs^Fmw, Gs^Fds, Gs^Fds, Gs^Fds, Gs^Fmw, Gs^Fds, Gg, Gg, Gg, Gg, Gg, Gs^Fms, Gs^Fms, Gs^Fms, Gs^Fms, Gg, Gs^Fms, Gg, Gs^Fms, Gs^Fms, Gs^Fms, Gs^Vh, Gs^Fms, Re^Gvs, Gg, Gg, Gg, Rd, Rd, Gg, Gg, Gg, Gg
Gs^Fds, Gs^Fds, Gs^Fds, Gs^Fds, Gs^Fds, Gs^Fds, Gs^Fds, Gs^Fds, Gs^Fds, Gs^Fds, Gs^Fds, Gs^Fds, Gs^Fds, Gs^Fds, Gs^Fds, Gs^Fds, Gs^Fds, Gs^Fds, Gg, Gg, Gg, Gg, Gs^Fms, Gs^Fms, Gs^Fms, Gs^Fms, Gg, Gs^Fms, Gs^Fms, Gs^Fms, Gs^Fms, Gs^Fms, Gs^Fms, Gs^Fms, Gg, Gg, Gg, Gg, Gg, Rd, Gg, Gg, Gg
