Hh, Mm, Hh, Mm, Mm, Mm, Hh, Mm, Mm, Mm, Mm, Mm, Mm, Mm, Mm, Mm, Mm, Mm, Mm, Mm, Mm, Mm, Mm, Mm, Mm, Mm, Mm, Mm, Mm, Mm, Mm, Mm, Mm, Mm, Mm, Mm, Mm, Mm, Mm, Mm, Hhd, Mm, Rd
Gg, Hh, Hh, Hh, Hh, Hh, Hh, Hh, Mm, Mm, Mm, Mm, Mm, Mm, Mm, Mm, Mm, Mm, Mm, Mm, Mm, Mm, Mm, Mm, Mm, Mm, Mm, Mm, Mm, Mm, Mm, Mm, Mm, Mm, Mm, Mm, Mm, Mm, Mm, Hhd, Rd, Rd, Hhd
Gg, Gg, Gg, Hh, Hh, Hh, Hh, Hh, Hh, Mm, Mm, Mm, Mm, Mm, Mm, Mm, Mm, Mm, Mm, Mm, Mm, Mm, Mm, Mm, Mm, Mm, Mm, Mm, Mm, Mm, Mm, Mm, Mm, Mm, Mm, Mm, Mm, Mm, Mm, Rd, Mm, Mm, Mm
Gg, Gg, Gg, Gg, Gs^Vh, Hh, Gg, Hh, Gg, Hh, Hh, Mm, Mm, Mm, Mm, Hh^Vhh, Hh, Mm, Mm, Mm, Mm, Mm, Mm, Mm, Mm, Mm, Mm, Mm, Mm, Mm, Mm, Mm, Mm, Mm, Mm, Mm, Hhd, Hhd, Rd, Rd, Mm, Mm, Mm
Gg, Gg, Gg, Gg, Gg, Gg, Gg, Gg, Gg, Hh, Hh, Hh, Hh, Mm, Hh, Hh, Hh, Hh, Hh, Mm, Mm, Mm, Mm, Mm, Mm, Mm, Mm, Mm, Mm, Mm, Mm, Mm, Mm, Mm, Mm, Mm, Rd, Rd, Mm, Mm, Mm, Mm, Mm
Rd, Gg, Gg, Gg, Gg, Gg, Gg, Gg, Cer, Cer, Cer, Hh, Hh, Hh, Hh, Hh, Hh, Hh, Hh, Hh, Hh, Mm, Mm, Mm, Mm, Mm, Mm, Mm, Mm, Mm, Mm, Mm, Mm, Mm, Mm, Mm, Rd, Hhd, Mm, Mm, Mm, Mm, Mm
Gg, Rd, Rd, Gg, Gg, Gg, Cer, Gg, Gg, 2 Ker, Cer, Gg, Hh, Hh, Hh, Hh, Hh, Mm, Mm, Hh, Hh, Mm, Mm, Mm, Mm, Mm, Mm, Mm, Mm, Mm, Mm, Mm, Mm, Mm, Hhd, Mm, Rd, Hhd, Hhd, Mm, Mm, Mm, Mm
Gg, Gg, Gg, Rd, Gg, Gg, Cer, 1 Ker, Cer, Gg, Gg, Gg, Gg, Hh, Gg, Hh, Hh, Mm, Mm, Mm, Mm, Hh, Hh^Vhh, Mm, Mm, Mm, Mm, Mm, Mm, Mm, Mm, Mm, Mm, Mm, Hhd, Rd, Mm, Mm, Mm, Mm, Mm, Mm, Mm
Gg, Gg, Gs^Vh, Rd, Rd, Gg, Gg, Cer, Gg, Gg, Gg, Gg, Gg, Gg, Gg, Gg, Mm, Mm, Hh, Mm, Mm, Hh, Hh, Hh, Mm, Mm, Mm, Hh, Hh, Mm, Mm, Mm, Mm, Mm, Mm, Rd, Hhd, Mm, Mm, Mm, Mm, Mm, Mm
Gg, Gg, Gg, Gg, Gg, Rd, Rd, Gg, Gg, Gg, Gg, Gg, Gg, Gs^Vh, Gg, Gg, Gg, Mm, Hh, Hh, Hh, Hh, Mm, Hh, Mm, Mm, Mm, Hh, Hh, Hh, Hh, Hh^Vhh, Hh, Mm, Mm, Mm, Rd, Mm, Mm, Mm, Mm, Mm, Mm
Gg, Gg, Gg, Gg, Gg, Gg, Rd, Gg, Gg, Gg, Gg, Gg, Gg, Gg, Hh, Gg, Gg, Gg, Gg, Hh, Hh, Mm, Hh, Mm, Mm, Mm, Mm, Mm, Hh, Mm, Mm, Hh, Hh, Hh, Hh, Hh, Rd, Hh, Hh, Mm, Mm, Mm, Mm
Gg, Gg, Gg, Gg, Gg, Gg, Gg, Rd, Rd, Gg, Gg, Gg, Gg, Hh, Hh, Hh, Gg, Gg, Gg, Hh, Gg, Hh, Hh, Hh, Hh, Mm, Mm, Mm, Hh, Hh, Mm, Mm, Mm, Hh, Hh, Hh, Rd, Gg, Hh, Hh, Mm, Mm, Mm
Gg, Gg, Gg, Gs^Fp, Gs^Fp, Gg, Gg, Gs^Vh, Gg, Rd, Gg, Gg, Gg, Gg, Hh, Hh, Hh, Hh, Gg, Gg, Gg, Hh, Hh, Hh, Hh, Hh^Vhh, Hh, Hh, Hh, Hh, Hh, Mm, Gg, Gg, Rd, Rd, Gg, Gg, Gg, Hh, Hh, Mm, Hh
Gs^Fp, Gs^Fp, Gs^Fp, Gg, Gs^Fp, Gg, Gg, Gg, Gg, Rd, Gg, Gg, Gg, Hh, Gg, Hh, Gg, Hh, Gg, Gg, Gg, Hh, Gg, Hh, Hh, Hh, Gg, Hh, Hh, Hh, Hh, Hh, Hh, Rd, Mm, Gg, Gg, Gg, Mm, Gg, Hh, Mm, Hh
Gs^Fp, Gs^Fp, Gs^Fp, Gs^Fp, Gs^Fp, Gs^Fp, Gg, Gg, Gg, Rd, Rd, Gs^Vh, Gg, Gg, Gg, Gg, Gg, Hh, Gg, Gll^Fp, Gg, Gg, Hh, Gg, Gg, Hh, Gg, Gg, Rd, Rd, Rd, Rd, Rd, Rd, Gg, Mm, Mm, Mm, Mm, Mm, Hh, Hh, Gg
Gg, Gs^Fp, Gs^Fp, Gg, Gg, Gs^Fp, Gs^Fp, Gg, Gll^Fp, Gg, Gg, Rd, Gg, Gg, Gg, Hh, Hh, Gg, Gs^Vh, Gg, Hh, Gg, Rd, Rd, Rd, Gg, Rd, Rd, Gg, Hh, Hh, Hh, Gg, Gg, Gg, Gg, Hh, Mm, Mm, Mm, Hh^Vhh, Hh, Gg
Gg, Gg, Gs^Fp, Gg, Gg, Gg, Gg, Gg, Gg, Gg, Gg, Rd, Rd, Gg, Gg, Hh, Hh, Hh, Hh, Hh, Gg, Gg, Rd, Hh, Hh, Rd, Hh, Gg, Gg, Gg, Hh, Gg, Gg, Hh, Gg, Hh, Hh^Vhh, Hh, Mm, Mm, Mm, Mm, Hh
Gg, Gg, Gg, Gg, Gg, Gg, Gg, Gg, Gs^Vh, Gg, Gg, Gg, Rd, Gg, Gg, Gg, Hh, Hh, Hh, Hh, Hh, Gg, Rd, Gg, Gg, Hh, Hh^Vhh, Hh, Hh, Gg, Hh, Gg, Hh, Gg, Gg, Gg, Hh, Hh, Hh, Mm, Mm, Hh, Hh
Gs^Fp, Gg, Gg, Gg, Gg, Gg, Gg, Gg, Gg, Gg, Gg, Gg, Rd, Gg, Gg, Gs^Fp, Gs^Fp, Gs^Fp, Gg, Hh, Hh, Gs^Vh, Rd, Rd, Rd, Gg, Hh, Hh, Hh, Gg, Hh, Hh, Hh, Gg, Gg, Hh, Hh, Hh, Hh, Hh, Hh^Vhh, Hh, Hh
Gs^Fp, Gs^Fp, Gs^Fp, Gs^Fp, Gs^Fp, Gg, Gs^Fp, Gs^Fp, Gs^Fp, Gs^Fp, Gg, Gg, Gg, Rd, Gs^Vh, Gg, Gg, Gs^Fp, Gs^Fp, Gg, Gg, Gg, Rd, Ch, Rd, Gg, Gg, Gg, Gg, Hh, Gg, Hh, Hh, Hh, Hh, Hh, Gg, Hh, Gg, Hh, Hh, Hh, Hh
Gs^Fp, Gs^Fp, Gs^Fp, Gs^Fp, Gs^Fp, Gs^Fp, Gs^Fp, Gs^Fp, Gs^Fp, Gs^Fp, Gg^Ve, Gg, Gg, Rd, Rd, Gg, Rd, Gs^Fp, Gg, Gg, Rd, Rd, Ch, Ch, Ch, Rd, Gg, Gg, Gg, Gg, Gg, Gg, Hh, Gg, Gg, Hh, Hh, Gg, Hh, Gg, Gg, Hh, Gg
Gg, Gs^Fp, Gs^Fp, Gg^Ve, Gg, Gg, Gg, Gs^Fp, Gs^Fp, Gg, Gll^Fp, Gll^Fp, Gg, Gg, Gg, Rd, Gg, Rd, Rd, Rd, Gg, Ch, Ch, 3 Kh, Ch, Rd, Rd, Gg, Gs^Vh, Gs^Fp, Gs^Fp, Hh, Gg, Hh, Gg, Gg, Gg, Gg, Gg, Hh, Hh, Gg, Hh
Gg, Gg, Gg, Gg, Gg, Gg, Gg, Gg, Gg, Gg, Gg, Gg, Gg, Gg, Gg, Gg, Gs^Fp, Gs^Fp, Gg, Gg, Gg, Gg, Gg, Ch, Gg, Gg, Gg, Rd, Rd, Gs^Fp, Gs^Fp, Gg, Gg, Hh, Hh, Gg, Gg, Hh, Hh, Hh, Hh, Hh, Gg
Gg, Gg, Gg, Gg, Gll^Fp, Gg, Gg, Gg, Gg, Gg, Gg, Gg, Gg, Gg, Gg, Gg, Gg, Gs^Fp, Gg, Gg, Gs^Vh, Gg, Gg, Gg, Gg, Gg, Gg, Hh, Hh, Rd, Rd, Gs^Fp, Gg, Gg, Gg, Gg, Hh, Hh, Hh, Hh^Vhh, Hh, Hh, Gg
Gs^Fds, Gg, Gs^Fds, Gg, Gg, Gll^Fp, Gg, Gs^Fds, Gs^Fds, Gg, Gg, Gg, Gg, Gg, Gg, Gg, Gg, Gg, Gg, Gg, Gg, Gs^Fp, Gg, Gg, Gg, Gg, Gs^Vh, Hh, Hh, Hh, Rd, Gg, Gg, Gg, Gg, Gg, Gg, Hh, Hh, Hh, Gg, Gg, Gg
Gg, Gs^Fds, Gg, Gs^Fds, Gs^Fds, Gg, Gg, Gg^Ve, Gs^Fds, Gs^Fds, Gs^Fds, Gs^Fds, Gs^Fds, Gs^Fds, Gs^Fds, Gg, Gg, Gg, Gg, Gg, Gg, Gs^Fp, Gs^Fp, Hh, Hh, Hh, Hh, Hh, Hh, Hh, Gg, Rd, Gg, Gg, Gg, Gg, Hh, Gg, Hh, Hh, Hh, Gg, Hh
Gg, Gs^Fds, Gs^Fds, Gs^Fds, Gs^Fds, Gs^Fds, Gs^Fds, Gg, Gg, Gs^Fds, Gs^Fds, Gs^Fds, Gs^Fds, Gg, Gs^Fds, Gg, Gg, Gg, Gg, Gg, Gg, Gg, Gs^Fp, Gs^Fp, Hh, Hh, Hh, Gs^Fp, Gs^Fp, Gg, Gg, Rd, Rd, Gg, Gg, Gg, Hh, Hh, Gg, Gg, Gg, Hh, Gg
Gs^Fds, Gs^Fds, Gg^Ve, Gs^Fds, Gs^Fds, Gs^Fds, Gs^Fds, Gg, Gs^Fds, Gs^Fds, Gs^Fds, Gs^Fds, Gs^Fds, Gs^Fds, Gs^Fds, Gs^Fds, Gs^Fds, Gg, Gg, Gg, Gg, Gg, Gg^Ve, Gs^Fp, Gg, Gg, Gg, Hh, Gs^Fp, Gs^Fp, Hh, Gg, Gg, Rd, Rd, Gg, Gg, Gg, Gg, Gg, Gg, Gg, Gg
Gg, Gg, Gs^Fds, Gg, Gg, Gs^Fds, Gs^Fds, Gs^Fds, Gs^Fds, Gs^Fds, Gs^Fds, Gs^Fds, Gs^Fds, Gg, Gs^Fds, Gg, Gg, Gg, Gg, Gg, Gg, Gg, Gg, Gg, Gg, Gg, Gg, Hh, Gg, Gg, Gg, Gg, Gg, Gg, Gg, Rd, Rd, Gg, Gg, Gg, 4 Gg, Gg, Gg
Gs^Fds, Gs^Fds, Gs^Fds, Gs^Fds, Gs^Fds, Gs^Fds, Gs^Fds, Gs^Fds, Gs^Fds, Gs^Fds, Gs^Fds, Gs^Fds, Gs^Fds, Gs^Fds, Gs^Fds, Gs^Fds, Gg, Gg, Gg, Gg, Gg, Gg, Gll^Fp, Gll^Fp, Gll^Fp, Gg, Gg, Gg, Gg, Gg, Gg, Gg, Gg, Gg, Gg, Gg, Gg, Rd, Rd, Gg, Gg, Gg, Gg
Gs^Fds, Gs^Fds, Gs^Fds, Gs^Fds, Gs^Fds, Gs^Fds, Gs^Fds, Gs^Fds, Gs^Fds, Gs^Fds, Gs^Fds, Gg^Ve, Gs^Fds, Gs^Fds, Gs^Fds, Gs^Fds, Gs^Fds, Gs^Fds, Gg, Gg, Gg, Gg, Gg, Gll^Fp, Gll^Fp, Gll^Fp, Gg, Gg, Gg, Gg, Gg, Gg, Gg, Gg, Gg, Gg, Gg, Gg, Gg, Rd, Gg, Gg, Gg
