Xu, Xu, Xu, Xu, Xu, Xu, Xu, Xu, Ww, Xu, Xu, Xu, Ww, Xu, Xu, Xu, Xu, Xu, Xu, Xu, Xu, Xu
Xu, Cud, Kud, Xu, Xu, Xu, Xu, Xu, Ww, Ww, Ww, Ww, Ww, Xu, Xu, Xu, Xu, Xu, Xu, Xu, Xu, Xu
Xu, Cud, Cud, Cud, Xu, Xu, Ur, Uu, Uu, Ww, Ww, Ww, Uu, Xu, Xu, Xu, 3 Kud, Xu, Xu, Xu, Xu, Xu
Xu, Uu, Uu, Uu, Ur, Ur, Xu, Xu, Xu, Uu, Uu, Uu, Xu, Xu, Uu, Cud, Cud, Cud, Xu, Xu, Xu, Xu
Xu, Xu, Xu, Uu, Xu, Xu, Uu^Vu, Xu, Xu, Xu, Uu, Xu, Ur, Uu, Xu, Uu, Uu, Uu, Ur, Uh, Xu, Xu
Xu, Xu, Xu, Uu, Ur, Ur, Ur, Xu, Uh, Xu, Ur, Ur, Xu, Xu, Xu, Xu, Xu, Xu, Ur, Ur, Xu, Xu
Xu, Xu, Xu, Ur, Xu, Xu, Ur, Uu, Uh, Uu, Ur, Uu^Vu, Xu, Uh, Uu, Uu^Vu, Ur, Xu, Xu, Ur, Uu^Vu, Xu
Xu, Xu, Xu, Xu, Xu, Xu, Uu^Vu, Ur, Ur, Xu, Ur, Xu, Uu, Ur, Xu, Xu, Ur, Xu, Xu, Ur, Uu, Xu
Xu, Xu, Xu, Xu, Xu, Xu, Xu, Xu, Uu, Ur, Uu, Xu, Ur, Ur, Uh, Xu, Xu, Ur, Ur, Uu, Uh, Xu
Xu, Xu, Xu, Xu, Xu, Uu^Vu, Ur, Uu, Xu, Xu, Ur, Uh, Xu, Xu, Xu, Xu, Xu, Xu, Xu, Uu^Vu, Uh, Xu
Xu, Xu, Xu, Uu, Ur, Ur, Uu, Xu, Xu, Xu, Ur, Xu, Xu, Xu, Uu^Vu, Xu, Xu, Uu, Xu, Xu, Xu, Xu
Xu, Xu, Xu, Uu, Uh, Ur, Ur, Xu, Xu, Uu, Ur, Uu, Xu, Xu, Ur, Uu, Uu, Uu, Xu, Xu, Xu, Xu
Xu, Xu, Xu, Ur, Xu, Uu, Xu, Uu, Uu^Vu, Xu, Xu, Uh, Ur, Ur, Uu, Xu, Xu, Ur, Xu, Xu, Xu, Xu
Xu, Xu, Xu, Ur, Uh, Xu, Xu, Xu, Xu, Xu, Xu, Uu, Xu, Xu, Uu, Xu, Uu, Ur, Xu, Uu^Vu, Xu, Xu
Xu, Xu, Xu, Ur, Ur, Xu, Xu, Uu^Vu, Ur, Xu, Xu, Xu, Xu, Xu, Xu, Xu, Xu, Ur, Ur, Uu, Xu, Xu
Xu, Xu, Xu, Ur, Uu^Vu, Xu, Uu^Vu, Xu, Uu, Ur, Ur, Uu, Ur, Uu^Vu, Ur, Uu^Vu, Xu, Uu, Ur, Xu, Uu, Xu
Xu, Xu, Uu, Ur, Xu, Xu, Xu, Ur, Xu, Uu, Ur, Ur, Xu, Uu, Xu, Xu, Xu, Xu, Uu, Xu, Uh, Xu
Xu, Xu, Ur, Uh, Xu, Xu, Ur, Ur, Xu, Xu, Uu, Xu, Xu, Ur, Xu, Uu, Xu, Xu, Xu, Uu, Uh, Xu
Xu, Xu, Ur, Xu, Xu, Uu, Xu, Xu, Xu, Xu, Uu, Xu, Xu, Ur, Ur, Uh, Xu, Uu^Vu, Xu, Ur, Uu^Vu, Xu
Xu, Xu, Uh, Ur, Ur, Uu, Xu, Xu, Cud, Cud, Uu, Cud, Cud, Xu, Xu, Uu, Ur, Ur, Ur, Ur, Xu, Xu
Xu, Xu, Uu^Vu, Uu, Xu, Uu^Vu, Xu, Xu, Xu, 1 Kud, Uu, 2 Kud, Xu, Xu, Xu, Uu, Xu, Xu, Xu, Uu^Vu, Xu, Xu
Xu, Xu, Xu, Xu, Xu, Xu, Xu, Xu, Xu, Xu, Uu, Xu, Xu, Xu, Xu, Xu, Xu, Xu, Xu, Xu, Xu, Xu
