Xu, Xu, Xu, Xu, Xu, Xu, Xu, Xu, Ww, Ww, Ww, Ww, Ww, Xu, Xu, Xu, Xu, Xu, Xu, Xu, Xu, Xu
Xu, Cud, 3 Kud, Xu, Xu, Xu, Xu, Xu, Ww, Ww, Ww, Ww, Ww, Xu, Xu, Xu, Xu, Xu, Xu, Xu, Xu, Xu
Xu, Cud, Cud, Cud, Xu, Xu, Uu^Vu, Xu, Xu, Ww, Uu, Ww, Xu, Xu, Xu, Xu, 4 Kud, Xu, Xu, Xu, Xu, Xu
Xu, Ur, Xu, Ur, Xu, Xu, Uh, Xu, Xu, Uu, Ur, Uu, Xu, Xu, Xu, Cud, Cud, Cud, Uu, Xu, Xu, Xu
Xu, Ur, Xu, Ur, Ur^Es, Uu, Uu, Xu, Xu, Xu, Ur, Xu, Xu, Xu, Uu, Uu, Ur, Ur, Uu, Xu, Xu, Xu
Xu, Uu, Xu, Xu, Xu, Ur, Uu, Xu, Ur^Es, Ur^Es, Uu, Xu, Xu, Uu, Uu^Vu, Xu, Xu, Ur, Ur, Xu, Xu, Xu
Xu, Uu, Xu, Xu, Xu, Xu, Uu, Uu, Xu, Xu, Ur, Xu, Xu, Ur, Uh, Xu, Xu, Xu, Xu, Uu, Xu, Xu
Xu, Uu, Xu, Xu, Uu^Vu, Uu, Uu, Xu, Xu, Xu, Ur, Uu, Uu, Ur, Uh, Xu, Xu, Xu, Uh, Uu, Xu, Xu
Xu, Ur, Xu, Xu, Uu, Xu, Uu, Xu, Xu, Xu, Xu, Ur, Xu, Uu, Xu, Xu, Xu, Xu, Uu^Vu, Ur^Es, Ur, Xu
Xu, Uu, Xu, Xu, Ur, Uu, Xu, Xu, Xu, Xu, Xu, Uh, Xu, Xu, Uh, Xu, Xu, Xu, Xu, Uu, Uu, Xu
Xu, Uu, Xu, Uh, Ur, Xu, Uu^Vu, Uh, Uu, Xu, Uu^Vu, Uu, Xu, Uh, Ur, Uu^Vu, Xu, Xu, Xu, Xu, Ur, Xu
Xu, Uu, Xu, Uh, Uu, Xu, Ur, Uu, Ur^Es, Xu, Xu, Xu, Uu, Ur, Xu, Uu, Uu, Uu, Ur, Xu, Ur^Es, Xu
Xu, Uu^Pr/, Uu, Xu, Xu, Uu, Ur, Xu, Uu, Ur^Es, Ur, Uu, Uh, Xu, Xu, Xu, Ur, Xu, Xu, Ur^Es, Xu, Xu
Xu, Uu, Uu, Xu, Uu, Uu, Uu, Xu, Xu, Xu, Xu, Xu, Xu, Xu, Xu, Xu, Ur^Es, Xu, Uu^Vu, Xu, Xu, Xu
Xu, Uu, Xu, Xu, Uu, Xu, Uu, Xu, Xu, Xu, Xu, Xu, Xu, Xu, Xu, Xu, Ur, Xu, Uu, Uu, Ur^Es, Xu
Xu, Xu, Ur^Es, Ur, Uu, Xu, Ur^Es, Xu, Xu, Xu, Uh, Xu, Xu, Xu, Uu^Vu, Xu, Uu, Xu, Ur, Xu, Ur^Es, Xu
Xu, Uu, Xu, Xu, Ur, Xu, Ur, Xu, Xu, Uh, Uu, Uh, Xu, Xu, Uu, Xu, Uu, Xu, Ur^Es, Xu, Ur, Xu
Xu, Uu, Xu, Uu, Uu, Ur, Xu, Xu, Ur, Ur, Ur, Ur, Ur, Xu, Uu, Xu, Xu, Uu, Xu, Xu, Uu, Xu
Xu, Ur, Xu, Xu, Xu, Uu^Vu, Xu, Uu, Xu, Uu, Ur, Uu, Xu, Uu, Xu, Uu^Vu, Xu, Xu, Xu, Xu, Uu, Xu
Xu, Ur^Es, Ur^Es, Uu^Vu, Uu, Xu, Ur, Uu, Xu, Cud, Ur, Cud, Xu, Ur, Xu, Xu, Uu, Uh, Ur, Xu, Ur, Xu
Xu, Xu, Xu, Uu, Xu, Ur, Uu, Uu^Vu, Xu, 1 Kud, Gg, 2 Kud, Xu, Ur, Ur, Uu, Xu, Uu, Xu, Ur^Es, Xu, Xu
Xu, Xu, Xu, Xu, Xu, Xu, Xu, Xu, Xu, Xu, Gg, Xu, Xu, Xu, Xu, Xu, Xu, Xu, Xu, Xu, Xu, Xu
