Gll^Fdf, Gll^Fdf, Gll^Fmf, Gll^Fdf, Gll^Fmf, Gll^Fmf, Gll^Fmf, Gll^Fmw, Gll^Fdf, Gll^Fdf, Gll^Fdf, Gll^Fmf, Gll^Fmf, Gll^Fdf, Gll^Fmf, Gll^Fmf, Gll^Fmf, Gll^Fdf, Gll^Fmf, Gll^Fdf, Gll^Fdf, Gll^Fdf, Gll^Fdf, Gs, Gll^Fdf, Gll^Fdf, Gll^Fmf, Gll^Fdf, Gll^Fdf
Gll^Fmf, Gll^Fmf, Gll^Fdf, Gll^Fmf, Gll^Fdf, Gs^Vl, Gll^Fdf, Gll^Fdf, Gll^Fdf, Gll^Fdf, Gll^Fdf, Gll^Fdf, Ce, Gll^Fdf, Gll^Fmf, Gll^Fdf, Gll^Fdf, Gll^Fmf, Gll^Fdf, Gll^Fmw, Gll^Fdf, Gll^Fdf, Gs, Gs, Gll^Fmf, Gll^Fmf, Gll^Fmf, Gll^Fdf, Gll^Fmf
Gll^Fdf, Gs^Vl, Gll^Fmf, Gll^Fmf, Gll^Fmf, Gll^Fmf, Gll^Fdf, Gll^Fdf, Gll^Fdf, Rb, Ce, Ce, Ce, Ce, Gll^Fmf, Gll^Fdf, Gll^Fdf, Gll^Fdf, Gd^Em, Gll^Fdf, Gd, Gll^Fmw, Gd, Gll^Fdf, Gll^Fdf, Gll^Fdf, Gll^Fdf, Gll^Fmf, Gll^Fdf
Gll^Fdf, Gll^Fdf, Gll^Fdf, Gll^Fdf, Gll^Fdf, Gll^Fdf, Ss, Gll^Fdf, Gll^Fdf, Rb, Ce, 6 Ke, Ce, Gll^Fdf, Gs^Vl, Gll^Fdf, Gll^Fdf, Gd, Gll^Fdf, Gll^Fmf, Gll^Fmw, Gll^Fdf, Gd, Gll^Fdf, Gll^Fdf, Gs^Vl, Gll^Fmf, Gll^Fdf, Gll^Fdf
Ss, Gll^Fdf, Ss, Gll^Fdf, Gll^Fdf, Gll^Fdf, Gll^Fdf, Gll^Fdf, Gll^Fdf, Rb, Rb, Ce, Gll^Fdf, Gll^Fmf, Gll^Fmf, Gll^Fdf, Gll^Fdf, Gll^Fdf, Gll^Fmf, Gll^Fmw, Gll^Fdf, Gll^Fdf, Gd, Gd, Gll^Fdf, Gll^Fmf, Gll^Fmw, Gll^Fdf, Gll^Fdf
Wo, Ss, Gll^Fdf, Gs^Vc, Gll^Fdf, Ss, Ss, Gll^Fdf, Gll^Fdf, Gll^Fdf, Gd, Gll^Fdf, Gll^Fdf, Gll^Fdf, Gll^Fdf, Gll^Fdf, Gll^Fdf, Gll^Fmf, Gll^Fdf, Gs^Vh, Gll^Fdf, Gd, Gll^Fdf, Gll^Fdf, Gll^Fmf, Gll^Fmf, Gll^Fmf, Gll^Fdf, Gll^Fmw
Wo, Ss, Gll^Fdf, Gll^Fdf, Gll^Fdf, Gll^Fdf, Ss, Gll^Fdf, Gll^Fdf, Gll^Fdf, Gll^Fdf, Gs, Gll^Fdf, Gll^Fdf, Gs, Gs, Gs, Gll^Fdf, Gll^Fdf, Gll^Fdf, Gd, Gd, Gll^Fdf, Gll^Fdf, Gll^Fmf, Gll^Fdf, Gll^Fmf, Gll^Fdf, Gll^Fmf
Ss, Wo, Wo, Ss, Gll^Fdf, Gll^Fdf, Gll^Fdf, Gll^Fdf, Gs^Vl, Gll^Fdf, Gd^Fetd, Gll^Fdf, Gll^Fdf, Gll^Fdf, Gll^Fdf, Gs^Vc, Gll^Fdf, Gll^Fdf, Gs, Gll^Fdf, Gll^Fdf, Gd, Gd, Gll^Fdf, Gll^Fdf, Gll^Fdf, Gll^Fdf, Gll^Fmf, Gll^Fmf
Gll^Fdf, Ss, Wo, Ss, Ss, Ss, Gll^Fdf, Gll^Fdf, Gll^Fdf, Gll^Fdf, Gll^Fdf, Gll^Fdf, Gll^Fdf, Gll^Fdf, Gll^Fdf, Gll^Fdf, Gll^Fmf, Gll^Fdf, Gll^Fdf, Gll^Fdf, Gs, Gd, Gll^Fdf, Gll^Fdf, Gll^Fdf, Gll^Fdf, Gll^Fdf, Gll^Fdf, Gll^Fdf
Gll^Fdf, Ss, Gll^Fdf, Wo, Wo, Gll^Fdf, Gll^Fdf, Gll^Fdf, Gll^Fdf, Gll^Fdf, Gll^Fdf, Ss, Gll^Fdf, Gll^Fdf, Gs, Gll^Fdf, Gll^Fmf, Gll^Fdf, Gll^Fdf, Gs, Gs^Vh, Gll^Fdf, Gll^Fdf, Gll^Fdf, Gs, Gs^Em, Gll^Fdf, Gll^Fmf, Gll^Fdf
Ss, Gll^Fdf, Ss, Ss, Ww, Gll^Fdf, Ss, Gll^Fdf, Gll^Fdf, Ss, Gll^Fdf, Ss, Gll^Fdf, Gll^Fdf, Gs^Em, Gll^Fdf, Gll^Fdf, Gll^Fdf, Gs, Gs, Gll^Fdf, Gll^Fdf, Gll^Fmf, Gll^Fdf, Gll^Fdf, Gll^Fdf, Gs^Vl, Gll^Fmf, Gll^Fdf
Gll^Fdf, Gll^Fmf, Gll^Fdf, Ss, Ww, Gll^Fdf, Ss, Gll^Fdf, Gll^Fdf, Gll^Fdf, Ww, Gll^Fdf, Gll^Fdf, Gll^Fdf, Gll^Fdf, Gd, Gs^Fmf, Gll^Fmf, Gll^Fmf, Gd, Gs, Gll^Fmf, Gll^Fdf, Gll^Fdf, Gs, Gll^Fmf, Gll^Fdf, Gll^Fdf, Gll^Fmf
Gll^Fmf, Gll^Fmf, Ss, Gll^Fdf, Gll^Fdf, Ww, Wo, Gll^Fdf, Gs^Vl, Gll^Fmf, Ww, Gll^Fdf, Gll^Fdf, Gll^Fmf, Gll^Fdf, Gd, Gll^Fdf, Gll^Fmf, Gll^Fmf, Gd, Gll^Fdf, Gll^Fdf, Gll^Fdf, Gll^Fdf, Gs, Gll^Fdf, Gll^Fdf, Gll^Fmf, Gll^Fdf
Gll^Fdf, Gll^Fmf, Gll^Fdf, Gll^Fdf, Gll^Fmf, Gll^Fdf, Gll^Fdf, Wo, Gll^Fdf, Gll^Fmf, Gll^Fdf, Ww, Gll^Fdf, Gll^Fmf, Gll^Fdf, Gd, Gll^Fmf, Gll^Fmf, Gd, Gd, Gll^Fmf, Gll^Fmf, Gll^Fmf, Gs, Gll^Fdf, Gs, Gll^Fmf, Gll^Fmf, Gll^Fdf
Gll^Fdf, Gll^Fdf, Ce, Gll^Fdf, Gll^Fdf, Gs^Vc, Gll^Fdf, Wo, Wo, Gll^Fdf, Gll^Fdf, Ww, Gll^Fdf, Gll^Fmf, Gll^Fmf, Gll^Fdf, Gll^Fmf, Gll^Fmf, Gd, Gll^Fdf, Gll^Fmf, Gll^Fmf, Gll^Fdf, Gll^Fmf, Gll^Fdf, Gll^Fmf, Gll^Fdf, Gll^Fdf, Gll^Fmf
Gll^Fdf, Ce, 5 Ke, Ce, Rb, Gll^Fdf, Gll^Fdf, Gll^Fdf, Gll^Fdf, Wo, Wo, Ww, Ww, Gll^Fdf, Gll^Fdf, Gll^Fmf, Gll^Fdf, Gll^Fdf, Gs, Gs^Vh, Gll^Fdf, Gll^Fdf, Gs, Gll^Fdf, Gll^Fdf, Gll^Fmf, Gs^Vl, Gll^Fdf, Gll^Fmf
Gll^Fdf, Ce, Ce, Ce, Rb, Gll^Fdf, Ss, Gll^Fdf, Gll^Fdf, Gll^Fdf, Gll^Fdf, Wo, Wo, Wo, Wo, Gll^Fdf, Gll^Fdf, Gs, Gll^Fdf, Gs, Gll^Fdf, Gll^Fdf, Gll^Fdf, Gs, Gll^Fdf, Gll^Fdf, Gll^Fmf, Gll^Fmf, Gll^Fmf
Gll^Fmf, Ce, Gll^Fmf, Rb, Gll^Fmf, Gll^Fmf, Ss, Gll^Fdf, Gs, Gs^Vc, Gll^Fdf, Gll^Fdf, Gll^Fdf, Gll^Fdf, Gll^Fdf, Wo, Ww, Ww^Bw|, Ww, Gll^Fdf, Gll^Fdf, Gs, Gll^Fdf, Chs, Chs, Khs, Gll^Fdf, Gll^Fmf, Gll^Fdf
Gll^Fdf, Gll^Fmf, Gll^Fmf, Gll^Fmf, Gll^Fmf, Gll^Fmw, Gll^Fdf, Gll^Fdf, Gll^Fdf, Gs^Em, Gll^Fdf, Gll^Fdf, Gll^Fdf, Gll^Fdf, Gll^Fdf, Gll^Fdf, Gll^Fdf, Gs, Gll^Fdf, Wo, Wo, Gll^Fdf, Wo, Chs, Ss, Chs, Gll^Fdf, Gll^Fdf, Gll^Fdf
Gll^Fdf, Gll^Fdf, Rb, Gs^Vl, Gll^Fdf, Gll^Fdf, Gs^Vc, Gll^Fdf, Gll^Fdf, Gs, Gll^Fdf, Gll^Fdf, Gll^Fdf, Gll^Fdf, Gll^Fdf, Gll^Fdf, Gll^Fdf, Gs, Gll^Fdf, Gll^Fdf, Gll^Fdf, Wo, Gll^Fdf, Wo, Wo, Ss, Gll^Fdf, Gll^Fdf, Gll^Fdf
Gll^Fdf, Gll^Fmf, Gll^Fdf, Rb, Gs, Gs, Gll^Fdf, Gll^Fdf, Gll^Fdf, Gll^Fdf, Gll^Fdf, Gs, Gll^Fdf, Gll^Fdf, Ss, Gll^Fdf, Gd^Em, Gd, Gll^Fmf, Gll^Fdf, Gll^Fdf, Gll^Fdf, Ss, Gll^Fdf, Gll^Fdf, Wo, Wo, Wo, Wo
Gll^Fmf, Gll^Fmw, Gll^Fdf, Gd, Gd^Em, Gll^Fdf, Ww, Gll^Fdf, Gll^Fdf, Gll^Fdf, Gll^Fdf, Gll^Fdf, Gll^Fdf, Gs^Vl, Gll^Fdf, Gs, Gd, Gll^Fdf, Gll^Fmw, Gll^Fdf, Gs, Gll^Fdf, Gll^Fdf, Ss, Gs^Vl, Gll^Fdf, Gll^Fdf, Gll^Fdf, Ss
Gll^Fmf, Gll^Fmf, Gll^Fmf, Gll^Fdf, Gll^Fdf, Gll^Fdf, Ww, Gll^Fdf, Gll^Fdf, Ss, Ss, Gll^Fdf, Ss, Gll^Fdf, Gll^Fdf, Gll^Fdf, Gd, Gll^Fdf, Gll^Fmf, Gs^Vl, Gs, Gll^Fdf, Gll^Fdf, Gll^Fdf, Gll^Fdf, Rb, Gll^Fdf, Gll^Fdf, Gll^Fmf
Gll^Fdf, Gll^Fdf, Gll^Fdf, Gll^Fmf, Ss, Gll^Fdf, Gll^Fdf, Ww, Ww, Gll^Fdf, Ss, Gll^Fdf, Gll^Fdf, Gll^Fdf, Gs, Gs, Gs^Vh, Gs, Gll^Fdf, Gll^Fdf, Gll^Fdf, Gs, Gll^Fdf, Gll^Fdf, Ce, Ce, Ce, Gll^Fdf, Gll^Fmf
Gll^Fdf, Gll^Fmw, Gll^Fdf, Gs^Vc, Gd, Ss, Gll^Fdf, Gll^Fdf, Ww, Gll^Fdf, Gll^Fdf, Gll^Fdf, Gll^Fdf, Gll^Fdf, Gd, Gll^Fdf, Gs, Gll^Fdf, Gll^Fdf, Gll^Fdf, Gd^Fetd, Gll^Fdf, Gll^Fmf, Rb, Ce, 4 Ke, Ce, Gll^Fdf, Gll^Fmf
Gll^Fdf, Gll^Fdf, Gs, Gll^Fdf, Gll^Fdf, Gll^Fdf, Wo, Gll^Fdf, Gll^Fdf, Ww, Gll^Fdf, Ss, Gll^Fdf, Gs, Gd, Gll^Fdf, Gll^Fdf, Gll^Fmf, Gs^Vl, Gll^Fmf, Gll^Fdf, Gll^Fmf, Gll^Fdf, Rb, Rb, Ce, Rb, Gll^Fdf, Gll^Fmf
Gll^Fdf, Gll^Fdf, Gs, Gll^Fdf, Wo, Wo, Gll^Fdf, Wo, Wo, Wo, Wo, Gll^Fdf, Gll^Fdf, Gll^Fdf, Ww^Bw|, Ww, Wo, Gll^Fdf, Gll^Fdf, Gll^Fdf, Gll^Fdf, Gll^Fdf, Gll^Fdf, Gll^Fdf, Rb, Gll^Fdf, Gll^Fdf, Gll^Fmw, Gll^Fdf
Gll^Fdf, Gll^Fdf, Ww, Ww, Gll^Fdf, Gll^Fdf, Ss, Gll^Fdf, Gll^Fdf, Gll^Fdf, Gll^Fdf, Wo, Wo, Ww, Gd, Gs, Gll^Fmf, Wo, Wo, Wo, Wo, Gll^Fdf, Gll^Fdf, Gll^Fdf, Gll^Fdf, Gll^Fdf, Gs^Vl, Gll^Fmf, Gll^Fdf
Gll^Fdf, Gll^Fdf, Wo, Gs, Gs^Vc, Ss, Gll^Fdf, Gll^Fdf, Gll^Fmf, Gll^Fmf, Gs^Vc, Gll^Fdf, Gd, Gd, Gll^Fdf, Gll^Fdf, Gll^Fmf, Gll^Fdf, Gll^Fdf, Gll^Fdf, Gll^Fdf, Wo, Wo, Gll^Fdf, Wo, Gll^Fdf, Gll^Fdf, Ss, Ss
Wo, Wo, Gll^Fdf, Gll^Fdf, Gs^Em, Gs, Gll^Fdf, Gll^Fmf, Gll^Fmf, Gll^Fmw, Gll^Fdf, Gll^Fdf, Gs, Gll^Fdf, Gll^Fdf, Gs, Gll^Fdf, Gll^Fdf, Gll^Fmf, Gll^Fdf, Ww, Ww, Gll^Fdf, Wo, Gll^Fdf, Wo, Wo, Gll^Fdf, Gll^Fdf
Gll^Fdf, Gll^Fdf, Gll^Fdf, Gll^Fdf, Gs, Ss, Gll^Fdf, Gll^Fmf, Gll^Fmw, Gll^Fmf, Gs, Gll^Fdf, Gs, Gll^Fdf, Gll^Fdf, Gs, Gll^Fdf, Gll^Fmf, Gll^Fdf, Gll^Fdf, Ww, Gll^Fdf, Gs^Vl, Gll^Fdf, Gll^Fdf, Gll^Fdf, Gll^Fdf, Wo, Wo
Ss, Ss, Gll^Fdf, Gll^Fdf, Gll^Fdf, Gll^Fdf, Ss, Gll^Fdf, Gll^Fdf, Gll^Fdf, Gd, Gd, Gs, Gll^Fmf, Gll^Fdf, Gs^Vl, Gll^Fdf, Gll^Fdf, Gll^Fdf, Gll^Fdf, Gll^Fdf, Gll^Fdf, Gll^Fmf, Gll^Fmf, Gs, Gll^Fdf, Gll^Fmf, Gll^Fdf, Gll^Fdf
Gll^Fdf, Gll^Fmf, Gll^Fmf, Gll^Fmw, Gd, Gll^Fmf, Gll^Fdf, Gll^Fdf, Gd, Gd, Gll^Fmf, Gll^Fmf, Gll^Fp, Gll^Fmf, Gll^Fdf, Gll^Fdf, Gll^Fmf, Gll^Fdf, Gd, Gll^Fdf, Gll^Fmw, Gll^Fmf, Gll^Fmw, Gll^Fdf, Gs^Vl, Gll^Fdf, Gll^Fmf, Gll^Fmw, Gll^Fdf
Gll^Fdf, Gll^Fmf, Gll^Fmf, Gll^Fmf, Gd, Gll^Fdf, Gll^Fdf, Gs^Vh, Gd, Gs^Vh, Gll^Fp, Gll^Fmf, Gd^Fetd, Gll^Fdf, Gll^Fdf, Gll^Fdf, Gll^Fmf, Gd, Gll^Fdf, Gll^Fmw, Gll^Fdf, Gll^Fdf, Gll^Fdf, Gd, Gs, Gll^Fdf, Gll^Fdf, Gs^Vl, Gll^Fmf
Gll^Fdf, Gll^Fmw, Gll^Fdf, Gd, Cer, Gll^Fdf, Cer, Gs, Gll^Fdf, Gll^Fdf, Gll^Fmf, Gll^Fmf, Gll^Fdf, Gs, Gll^Fdf, Gll^Fmw, Gll^Fp, Gs, Gll^Fmw, Gs^Vl, Gll^Fmf, Gll^Fdf, Gll^Fdf, Gll^Fdf, Ce, Gll^Fdf, Gll^Fdf, Gll^Fdf, Gll^Fdf
Gll^Fdf, Gll^Fdf, Gs, Cer, 1 Ker, Re, 2 Ker, Cer, Gd, Gd, Gll^Fmf, Gll^Fp, Gll^Fmf, Gll^Fdf, Gll^Fp, Gll^Fmf, Gll^Fp, Gll^Fp, Gll^Fmw, Gll^Fmw, Gll^Fdf, Rb, Rb, Rb, Ce, Ce, Ce, Gll^Fdf, Gll^Fdf
Gll^Fdf, Gll^Fdf, Gs, Cer, Cer, Re, Cer, Cer, Gd, Gll^Fmf, Gll^Fdf, Gll^Fdf, Gll^Fdf, Gll^Fmf, Gd, Gs^Vl, Gll^Fmf, Gll^Fmw, Gll^Fp, Gll^Fdf, Gll^Fdf, Gll^Fdf, Gll^Fdf, Ce, Ce, 3 Ke, Ce, Gll^Fdf, Gll^Fdf
Gll^Fdf, Gs, Gll^Fdf, Gll^Fdf, Rb, Rb, Gs, Gll^Fdf, Gll^Fdf, Gll^Fdf, Gll^Fdf, Gs, Gd, Gd, Gll^Fdf, Gll^Fdf, Gll^Fp, Gll^Fmf, Gll^Fmw, Gll^Fmw, Gll^Fmf, Gll^Fdf, Gll^Fmf, Gll^Fdf, Gll^Fdf, Ce, Gll^Fdf, Gll^Fdf, Gll^Fdf
Gll^Fdf, Gll^Fdf, Gll^Fdf, Gll^Fdf, Rb, Rb, Gs, Gll^Fmf, Gll^Fmf, Gll^Fmf, Gll^Fdf, Gll^Fdf, Gs, Gs, Gll^Fdf, Gll^Fp, Gll^Fp, Gll^Fp, Gll^Fmw, Gll^Fp, Gll^Fp, Gll^Fmf, Gll^Fmf, Gll^Fmf, Gll^Fmf, Gll^Fmf, Gll^Fmf, Gll^Fmf, Gll^Fmf
