Hh, Hh, Mm, Hh, Mm, Mm, Mm, Mm, Mm, Mm, Mm, Mm, Mm, Mm, Mm, Hh, Mm, Hh, Hh, Hh, Hh, Hh, Hh, Hh, Hh, Hh, Hh, Hh, Mm, Hh, Hh, Gg, Gg, Gg, Gg, Gg, Gg, Gg, Gg, Gg, Re^Gvs, Gg, Gg, Ds, Ds, Ds, Gg
Hh, Mm, Hh, Mm, Mm, Mm, Mm, Mm, Mm, Mm, Mm, Mm, Hh, Mm, Mm, Mm, Mm, Mm, Mm, Hh, Hh, Hh, Hh, Mm, Mm, Mm, Mm, Hh, Hh, Hh, Hh, Gg, Gg, Gg, Gs^Fms, Gg, Gs^Fms, Gg, Gg, Re^Gvs, Re^Gvs, Gg, Gg, Ds, Ds, Ds, Gg
Hh, Hh, Hh, Hh, Hh, Mm, Mm, Mm, Mm, Mm, Mm, Mm, Hh, Hh, Hh, Hh, Hh, Hh, Hh, Hh, Hh, Hh, Hh, Hh, Hh, Hh, Mm, Mm, Mm, Hh, Mm, Hh, Hh, Hh, Hh, Gs^Fms, Gs^Fms, Gg, Re^Gvs, Re^Gvs, Re^Gvs, Gs^Vh, Re^Gvs, Ds, Gg, Gg, Gg
Hh, Mm, Mm, Hh, Hh, Hh, Hh, 4 Mm, Mm, Mm, Mm, Hh, Hh, Hh, Ww, Hh, Hh, Hh, Hh, Hh, Hh, Mm, Mm, Mm, Hh, Hh^Vhh, Mm, Mm, Hh, Mm, Hh, Hh, Hh, Hh, Hh, Gs^Fms, Gs^Fms, Re^Gvs, Re^Gvs, Re^Gvs, Re^Gvs, Re^Gvs, Re^Gvs, Gg, Gg, Gg, Rr
Mm, Hh, Mm, Hh, Mm, Hh, Hh, Hh, Hh, Mm, Mm, Mm, Mm, Hh, Gg, Ww, Ww, Hh, Gg, Gg, Gs^Fms, Hh, Hh, Hh, Hh, Hh, Hh, Hh, Hh, Hh, Hh, Gg, Gg, Hh, Gg, Gg, Gg, Gg, Ds, Re^Gvs, Ds, Gg, Gg, Gg, Rr, Rr, Gg
Mm, Mm, Mm, Mm, Mm, Hh, Hh, Hh, Hh, Hh, Hh, Mm, Mm, Mm, Gg, Hh, Hh, Ww, Ww, Gg, Gg, Gg, Gg, Hh, Gg, Hh, Gg, Hh, Gg, Hh, Gg, Gg, Gg, Gg, Gg, Gg, Re^Gvs, Ds, Gg, Ds, Gg, Gg, Rr, Rr, Ds, Ds, Ds
Hh, Mm, Mm, Mm, Hh, Hh, Hh, Hh, Hh, Mm, Mm, Gg, Mm, Hh, Gg, Hh, Hh, Hh, Hh, Ww, Ww, Gg, Ww, Gg, Gg, Gg, Gg, Gg, Gg, Gg, Re^Gvs, Gg, Gg, Gg, Re^Gvs, Re^Gvs, Re^Gvs, Gs^Vh, Re^Gvs, Gg, Rr, Rr, Ds, Ds, Ds, Ds, Ds
Mm, Hh, Hh, Hh, Hh, Hh, Gg, Gg, Hh, Gg, Hh, Mm, Hh, Hh, Hh, Hh, Hh, Hh, Hh, Hh, Gg, Ww, Ch, Ww, Ww, Gg, Gs^Vh, Gg, Re^Gvs, Gg, Re^Gvs, Re^Gvs, Gg, Gg, Re^Gvs, Re^Gvs, Re^Gvs, Re^Gvs, Re^Gvs, Ch, Rr, Ch, Gg, Gg, Gg, Ds, Ds
Mm, Hh, Mm, Hh, Hh^Vhh, Hh, Hh, Gg, Gg, Gg, Gg, Gg, Gg, Gg, Hh, Hh, Hh, Hh^Vhh, Hh, Hh, Gg, Ch, Ch, Ch, Ww, Gg, Gg, Gg, Re^Gvs, Re^Gvs, Re^Gvs, Gg, Gg, Re^Gvs, Gg, Re^Gvs, Gg, Re^Gvs, Rr, Rr, Gg, Gg, Re^Gvs, Gg, Gg, Ds, Gg
Mm, Mm, Mm, Hh, Hh, Hh, Hh, Hh, Mm, Gg, Mm, Hh, Mm, Hh, Mm, Hh, Hh, Hh, Hh, Hh, Rd, Gg, Gg, Gg, Ww^Bw/, Rd, Rd, Gg, Re^Gvs, Re^Gvs, Gg, Re^Gvs, Gs^Fms, Gg, Gg, Gg, Rr, Rr, Gs^Fms, Gs^Fms, Re^Gvs, Re^Gvs, Re^Gvs, Gs^Vh, Gg, Gg, Gg
Gg, Mm, Gg, Mm, Gg, Gg, Hh, Mm, Hh, Mm, Hh, Mm, Mm, Mm, Hh, Hh, Hh, Mm, Hh, Hh, Hh, Rd, Rd, Rd, Gg, Ww, Gs^Fms, Rd, Re^Gvs, Re^Gvs, Gs^Fms, Gg, Gg, Gg, Gg, Rr, Gg, Gg, Gg, Gg, Re^Gvs, Re^Gvs, Re^Gvs, Re^Gvs, Gg, Gg, Gs^Fds
Gg, Hh, Hh, Gg, Gg, Hh, Gg, Hh, Ww, Ww, Hh, Hh, Hh, Hh, Hh^Vhh, Hh, Hh, Hh, Gs^Fms, Hh, Hh, Hh, Rd, Gs^Fms, Gs^Fms, Ww, Gg, Rd, Gs^Fms, Gs^Fms, Rd, Rd, Rd, Gg, Gg, Rr, Gg, Rr^Vhc, Gg, Gg, Gg, Re^Gvs, Gg, Gg, Gg, Gs^Fds, Gs^Fds
Gg, Gg, Hh, Gg, Hh, Gg, Gg, Gg, Ww, Hh, Ww, Ww, Ww, Gg, Gg, Hh, Gg, Hh, Gg, Gs^Fms, Rd, Rd, Gs^Fms, Gs^Fms, Gs^Fms, Ww, Ds, Rd, Rd, Rd, Re^Gvs, Re^Gvs, Gg, Rd, Rr, Rr, Re^Gvs, Gg, Re^Gvs, Gg, Gg, Gg, Gg, Gg, Gg, Gs^Fds, Gs^Fds
Hh, Hh, Hh, Hh, Hh, Hh, Hh, Gg, Gg, Ww, Hh, Hh, Ww, Hh, Ww, Hh, Hh, Hh, Hh, Gs^Fms, Rd, Gs^Fms, Gs^Fms, Gs^Fms, Gg, Ww, Ds, Gg, Rr^Vhc, Re^Gvs, Re^Gvs, Re^Gvs, Gg, Rr, Gg, Gg, Re^Gvs, Re^Gvs, Re^Gvs, Re^Gvs, Re^Gvs, Gg, Gs^Fds, Gg, Gs^Fds, Gs^Fds, Gs^Fds
Gs^Fms, Hh, Gs^Fms, Gs^Fms, Gs^Fms, Gg, Hh, Hh, Hh, Gg, Gg, Hh, Hh, Ww, Ww, Ww, Ww, Gg, Rd, Rd, Gs^Fms, Gs^Fms, Gs^Fms, Gs^Fms, Ww, Ww, Ds, Ds, Gg, Re^Gvs, Gg, Gs^Vh, Rr, Rr, Rr, Gg, Gs^Vh, Re^Gvs, Re^Gvs, Re^Gvs, Re^Gvs, Gs^Fds, Gs^Fds, Gs^Fds, Gs^Fds, Gs^Fds, Gs^Fds
Gg, Gs^Fms, Hh, Gs^Fms, Gs^Fms, Gg, Gs^Fms, Gg, Hh, Hh, Hh, Hh, Gg, Gg, Gg, Gg, Rd, Ww^Bw/, Ww, Gg, Gs^Fms, Gs^Fms, Ww, Ww, Gg, Gg, Gg, Ds, Gg, Gg, Rr, Rr, Ch, Rr, Rr, Rr, Rr, Gg, Gg, Re^Gvs, Gg, Gs^Fds, Gs^Fds, Gs^Fds, Gs^Fms, Gg^Fet, Gs^Fms
Gs^Fms, Gg, Gg, Hh, Gs^Fms, Gg^Fet, Gs^Fms, Gg, Hh, Hh, Gg, Gg, Gg, Gs^Fms, Gg, Gg, Rd, Gg, Gg, Ww, Gs^Fms, Gs^Fms, Ww, Gg, Rr^Vhc, Gg, Gg, Gg, Gg, Rr, Ch, Ch, Rr^Vhc, Rr^Vhc, Ch, Ch, Ch, Rr, Gs^Vh, Gg, Gg, Gg, Gs^Fms, Gs^Fms, Gs^Fms, Gs^Fms, Gs^Fds
Gs^Fms, Gg, Gg, Gg, Gs^Fms, Gs^Fms, Gs^Fms, Gs^Fms, Gs^Fms, Gs^Fms, Gg, Gg, Re^Gvs, Gg, Gg, Gg, Rd, Gg, Gg, Ww, Ww, Gs^Fms, Ww, Gg, Gg, Gg, Gg, Gg, Gs^Vh, Rr, Ch, Rr^Vhc, Ch, Ch, Ch, Rr^Vhc, Ch, Rr, Gg, Gg, Ds, Gs^Fms, Gg, Gs^Fms, Gs^Fms, Gs^Fds, Gs^Fds
Gs^Fms, Gg, Gs^Fms, Gg, Gs^Fms, Gs^Fms, Gs^Fms, Gg, Gs^Fms, Gs^Fms, Gg, Gg, Re^Gvs, Re^Gvs, Re^Gvs, Re^Gvs, Rd, Gg, Gs^Fms, Gg, Gg, Ww, Ww, Ww, Ch, Ch, Gg, Gg, Gg, Rr, Rr, Ch, Ch, 3 Kh, Ch, Ch, Rr, Rr, Ds, Ds, Ds, Gs^Fms, Gg, Gs^Fms, Gs^Fms, Gs^Fds, Gs^Fds
Gg, Gs^Fms, Gg, Gg, Gg, Gg, Gg, Gg, Gg, Gg, Gs^Vh, Re^Gvs, Re^Gvs, Re^Gvs, Re^Gvs, Rd, Gs^Fms, Gs^Fms, Re^Gvs, Re^Gvs, Gs^Vh, Gg, Gg, Ww, Ww, Ch, Rr, Gg, Rr, Rr, Rr, Ch, Ch, Ch, Rr^Vhc, Ch, Rr, Gs^Vh, Gg, Gg, Gg, Ds, Gg, Gg, Gs^Fms, Gs^Fms, Gg
Gg, Gg, Gg, Gg, Re, Gg, Gg, Gg, Gg, Gg, Gg, Re^Gvs, Gg, Re^Gvs, Re^Gvs, Rd, Re^Gvs, Re^Gvs, Re^Gvs, Re^Gvs, Re^Gvs, Gg, Rr, Gg, Ww^Bsb/, Rr, Gg, Rr, Gg, Gs^Vh, Gg, Rr, Ch, Rr^Vhc, Rr, Ch, Rr, Gg, Re^Gvs, Re^Gvs, Re^Gvs, Gg, Gg, Gg, Gs^Fms, Gs^Fms, Gs^Fms
Gg, Gg, Gg, Re, Chr, Re^Es, Re^Es, Re, Re, Gg, Gg, Gs^Fms, Gs^Fms, Gg, Gg, Rd, Gg, Gg, Rr, Re^Gvs, Rr, Rr, Gg, Rr, Ww, Gg, Gg, Gg, Gg, Gg, Gg, Rr, Rr, Ch, Rr, Rr, Gg, Gg, Gg, Re^Gvs, Re^Gvs, Re^Gvs, Gg, Gg, Gg, Gs^Fms, Gs^Fms
Gg, Gg, Re, Re, 2 Khr, Chr, Re, Chr, Re, Gg, Gg, Gg, Gg, Gg, Rr, Rd, Rr, Rr, Re^Gvs, Rr, Gg, Gg, Ds, Ds, Ww, Ds, Ds, Gg, Gg, Rr^Vhc, Gg, Gg, Gg, Rr, Gg, Rr, Rr, Gg, Gg, Rr^Vhc, Re^Gvs, Re^Gvs, Re^Gvs, Re^Gvs, Gg, Gg, Gg
Rr, Rr, Rr, Chr, Chr, Chr, Rr, Rr, Rr, Rr, Rr, Rr, Rr, Rr, Gg, Rr, Re^Gvs, Re^Gvs, Re^Gvs, Gg, Gg, Gg, Ds, Ww, Ww, Ww, Gs^Fds, Gg, Gs^Fms, Gg, Gg, Gs^Fms, Gs^Fms, Gs^Fms, Gg, Gg, Gg, Rr, Rr, Gg, Re^Gvs, Re^Gvs, Re^Gvs, Gg, Gg, Gg, Gg
Gg, Gg, Re, 1 Khr, Chr, Chr, Re^Es, Chr, Chr, Re, Gg, Gg, Gg, Gg, Gg, Re^Gvs, Re^Gvs, Re^Gvs, Re^Gvs, Gs^Vh, Gg, Ds, Ww, Ww, Gs^Fds, Gs^Fds, Gs^Fms, Gs^Fms, Gs^Fms, Gs^Fms, Gs^Fms, Gs^Fms, Gs^Fms, Gs^Fms, Gg, Gg, Gg, Gg, Rr, Gg, Gg, Gs^Vh, Gg, Re^Gvs, Gg, Gg, Gg
Gg, Gg, Gg, Re, Re^Es, Chr, Re^Es, Re, Re, Re, Gg, Gg, Gg, Gg, Gg, Re^Gvs, Gg, Gg, Gg, Gg, Gg, Ww, Ww, Gs^Fds, Gs^Fds, Gs^Fms, Gs^Fds, Gs^Fms, Gg^Fet, Gs^Fms, Gs^Fds, Gs^Fms, Gg, Gs^Fms, Gg, Gg, Re^Gvs, Gg, Gg, Rr, Rr, Gg, Ch, Gg, Gg, Gs^Fms, Gg
Gg, Gg, Gg, Gg, Gg, Re^Es, Gg, Gg, Gg, Gg, Gs^Vh, Re^Gvs, Re^Gvs, Gg, Gg, Gg, Gs^Fds, Gg, Gs^Fms, Gs^Fms, Ww, Ww, Gs^Fds, Gs^Fds, Gs^Fds, Gs^Fds, Gs^Fds, Gs^Fds, Gs^Fds, Gs^Fds, Gs^Fds, Gs^Fds, Gs^Fds, Gs^Fms, Gs^Fms, Gs^Fms, Re^Gvs, Re^Gvs, Gg, Gg, Ch, Rr, Rr, Gg, Gg, Gg, Gg
Gg, Gg, Gg, Gg, Gg, Gg, Gg, Gg, Gg, Gg, Re^Gvs, Re^Gvs, Re^Gvs, Gg, Gg, Gs^Fds, Gs^Fds, Gs^Fms, Gs^Fms, Gg, Ww, Ww, Gs^Fds, Gs^Fds, Gs^Fds, Gs^Fds, Gs^Fds, Gs^Fds, Gs^Fds, Gs^Fds, Gs^Fds, Gs^Fds, Gs^Fds, Gg, Gs^Fms, Gs^Fms, Gs^Vh, Re^Gvs, Re^Gvs, Gg, Gg, Gg, Gg, Rr, Rr, Gg, Gg
Gg, Gg, Gg, Gs^Vh, Re^Gvs, Re^Gvs, Re^Gvs, Gs^Fms, Gg, Re^Gvs, Re^Gvs, Re^Gvs, Gs^Fms, Gs^Fms, Gg, Gs^Fds, Gs^Fds, Gs^Fms, Ds, Gg, Ww, Ww, Gg, Gs^Fds, Gg, Gs^Fds, Gs^Fds, Gs^Fds, Re^Gvs, Gs^Fds, Re^Gvs, Gs^Fds, Gg, Gs^Fms, Gg, Gg, Re^Gvs, Re^Gvs, Re^Gvs, Re^Gvs, Re^Gvs, Gg, Ds, Gg, Ds, Rr, Rr
Gg, Gg, Re^Gvs, Re^Gvs, Re^Gvs, Re^Gvs, Re^Gvs, Gg, Gg, Gg, Gg, Gs^Fms, Gs^Fms, Gs^Fms, Gg, Gg, Gg, Ds, Ww, Ww, Ww, Ds, Gg, Gg, Gg, Gs^Vh, Re^Gvs, Re^Gvs, Re^Gvs, Re^Gvs, Gg, Gg, Gs^Fms, Gs^Fms, Gg, Gg, Gg, Re^Gvs, Re^Gvs, Re^Gvs, Re^Gvs, Re^Gvs, Ds, Ds, Ds, Ds, Gg
Gg, Gg, Gg, Re^Gvs, Gg, Gg, Gg, Gs^Fms, Gg, Gg, Re^Gvs, Gg, Gg, Gg, Gs^Fms, Gg, Gs^Fms, Ds, Ww, Ww, Gs^Fds, Ds, Gg, Gg, Gg, Re^Gvs, Gg, Re^Gvs, Gg, Gg, Gs^Fms, Gs^Fms, Gg, Gg, Gs^Fms, Gg, Gg, Gg, Re^Gvs, Re^Gvs, Gs^Vh, Gg, Gg, Ds, Gg, Ds, Ds
Gg, Gg, Gg, Gg, Gg, Gg, Gs^Fms, Gs^Fms, Re^Gvs, Re^Gvs, Re^Gvs, Gs^Vh, Re^Gvs, Gg, Gs^Fms, Gs^Fms, Gs^Fms, Gs^Fms, Ww, Gs^Fds, Gs^Fds, Gs^Fds, Gs^Fds, Gs^Fms, Gs^Fms, Gs^Fms, Gs^Fds, Gs^Fds, Gs^Fds, Gs^Fds, Gs^Fds, Gs^Fms, Gs^Fms, Gs^Fms, Gs^Fms, Gg, Gg, Gg, Gg, Gg, Gg, Gg, Gg, Gg, Gg, Gg, Gg
Gg, Gg, Gg, Gs^Fms, Gg, Gs^Fms, Gg, Gs^Fms, Re^Gvs, Re^Gvs, Re^Gvs, Re^Gvs, Re^Gvs, Re^Gvs, Gg, Gg, Gg, Ww, Ww, Gs^Fds, Gs^Fds, Gs^Fds, Gs^Fds, Gs^Fds, Gs^Fds, Gs^Fms, Gs^Fds, Gs^Fds, Gs^Fds, Gs^Fds, Gs^Fds, Gs^Fds, Gs^Fds, Gs^Fms, Gs^Fms, Gg, Gg, Gg, Gg, Gg, Gg, Gg, Gg, Gg, Gg, Gg, Gg
