Hh, Hh, Hh, Hh, Gg, Gg, Hh, Hh, Hh, Hh, Hh, Hh, Gg, Gg, Gg, Gg, Hh, Gg, Hh, Hh, Hh, Hh, Hh, Hh, Hh, Hh, Hh, Hh, Gg, Gg, Gg, Gg, Gg, Gg, Gg, Gg, Gg, Gg, Gg, Gg, Gg, Gg, Gg, Gg, Gg, Gg, Rr
Hh, Hh, Hh, Hh, Hh, Hh, Hh, Hh, Hh, Hh, Hh, Hh, Hh, Hh, Hh, Hh, Gg, Hh, Hh, Hh, Hh, Hh, Hh, Hh, Hh, Hh, Gs^Fds, Gs^Fds, Gs^Fds, Gg, Gg, Gg, Gg, Gg, Gg, Gg, Ds, Gg, Gg, Gg, Gg, Gg, Gg, Gg, Rr, Rr, Gg
Hh, Hh, Hh, Hh, Hh, Hh, Gg, Hh, Gg, Hh, Gg, Hh, Gg, Gg, Gg, Gg, Hh, Hh, Hh, Hh, Hh, Hh, Gg, Gg, Gs^Fds, Gs^Fds, Gs^Fds, Gs^Fds, Gg, Gg, Gg, Gg, Gg, Gg, Ds, Ds, Ds, Ds, Gg, Gg, Gg, Gg, Gg, Rr, Gg, Gg, Gg
Hh, Hh, Hh, Hh, Gg, Gg, Gg, Gg, Gg, Gg, Gg, Gg, Gg, Gg, Gg, Gg, Hh, Hh, Hh, Hh, Gg, Gg, Gs^Fds, Gs^Fds, Gg, Gg, Gg, Gg, Gg, Gg, Gg, Gg, Gg, Ds, Ds, Ds, Ds, Ds, Gg, Gg, Gg, Gg, Rr, Rr, Gg, Gg, Gg
Hh, Hh, Hh, Gg, Gg, Gg, Gg, Gg, Gg, Gg, Gg, Gg, Gg, Gg, Hh, Hh, Hh, Hh, Gg, Gg, Gg, Gg, Gg, Gg, Gg, Gg, Gg, Gg, Gg, Gg, Gg, Gg, Ds, Ds, Ds, Ds, Ds, Ds, Gg, Gg, Rr, Rr, Gs^Fds, Gg, Gg, Gg, Gg
Hh, Hh, Gg, Gg, Hh, Gg, Hh, Hh, Gg, Gg, Gg, Gg, Hh, Hh, Hh, Hh, Gg, Gg, Gg, Gg, Gg, Gg, Gg, Gg, Gg, Gg, Gg, Gg, Gg, Gg, Ds, Ds, Gg, Ds, Gg, Ds, Gg, Gg, Rr, Rr, Gs^Fds, Gs^Fds, Gg, Gg, Gg, Gg, Gg
Gg, Gg, Hh, Hh, Hh, Hh, Gg, Gg, Gg, Gg, Gg, Gg, Hh, Hh, Gg, Gg, Gg, Gg, Gg, Gg, Gg, Gg, Gg, Gg, Hh, Gg, Gg, Gg, Gg, Gg, Gg, Gg, Gg, Gg, Gg, Gg, Gg, Gg, Rr, Gg, Gg, Gg, Gg, Gg, Gg, Gg, Gg
Hh, Hh, Hh, Hh, Hh, Hh, Hh, Gg, Gg, Gg, Gg, Gg, Gg, Gg, Gg, Gg, Gg, Gg, Gg, Gg, Gg, Gg, Hh, Hh, Gg, Gg, Gg, Gg, Gg, Gg, Gg, Gg, Gg, Gg, Gg, Gg, Rr, Rr, Gg, Gg, Gg, Gg, Gg, Gg, Gg, Gg, Ds
Hh, Hh, Hh, Hh, Hh, Hh, Hh, Gg, Gg, Gg, Gg, Gg, Gg, Gg, Gg, Gg, Hh, Hh, Hh, Gg, Hh, Hh, Gg, Gg, Gg, Gg, Gg, Gg, Gg, Gg, Gg, Gg, Gg, Gg, Gg, Rr, Gg, Gg, Gg, Gg, Gg, Gg, Gg, Gg, Ds, Ds, Ds
Gg, Hh, Hh, Hh, Hh, Hh, Hh, Hh, Gg, Gg, Gg, Gg, Gg, Gg, Hh, Hh, Hh, Hh, Hh, Hh, Hh, Hh, Gg, Gg, Gg, Gg, Gg, Gg, Gg, Gg, Gg, Gg, Gg, Gg, Ch, Rr, Ch, Gg, Gg, Gg, Gg, Gg, Ds, Ds, Ds, Ds, Ds
Hh, Hh, Hh, Hh, Hh, Hh, Hh, Gg, Hh, Gg, Hh, Gg, Hh, Hh, Hh, Hh, Hh, Hh, Gs^Fds, Hh, Gg, Gg, Hh, Hh, Gg, Gg, Gg, Gg, Gg, Gg, Gg, Gg, Ch, Ch, Rp, Rr, Rb^Vh, Ch, Ch, Gg, Gg, Gg, Gg, Ds, Ds, Ds, Gg
Hh, Hh, Hh, Hh, Hh, Hh, Hh, Hh, Hh, Hh, Hh, Hh, Hh, Hh, Hh, Hh, Gs^Fds, Gs^Fds, Gs^Fds, Gs^Fds, Gg, Hh, Gg, Gg, Gg, Gg, Gg, Gg, Gg, Gg, Ch, Ch, Rp, Rp, Rr^Vhc, Rr, Rr, Rb^Vc, Rp, Ch, Gg, Gg, Gg, Gg, Gg, Gg, Gg
Hh, Hh, Gg, Hh, Hh, Hh, Hh, Hh, Hh, Hh, Hh, Hh, Hh, Hh, Hh, Hh, Gs^Fds, Gs^Fds, Gs^Fds, Gg, Gs^Fds, Gg, Gg, Gg, Gg, Gg, Gg, Gg, Gg, Ch, Rb^Vh, Rb^Vh, Rp, Rr^Vhc, Rp, Rr, Rr, Rr^Vhc, Rp, Ch, Ch, Gg, Gg, Gg, Gg, Gg, Gg
Gg, Gg, Gg, Hh, Gg, Gg, Gg, Hh, Gg, Gg, Gg, Hh, Gg, Gg, Gs^Fds, Gs^Fds, Gs^Fds, Gs^Fds, Gs^Fds, Gs^Fds, Gs^Fds, Gg, Gg, Gg, Gg, Gg, Gg, Gg, Gg, Ch, Rp, Rp, Rr, Rp, Ch, Ch, Ch, Rp, Rp, Rr, Rb^Vh, Ch, Gg, Gg, Gg, Gg, Gg
Gg, Gg, Gg, Gg, Gg, Gg, Gg, Gg, Gg, Gg, Gg, Gg, Gg, Gg, Gg, Gg, Gg, Gs^Fds, Gs^Fds, Gs^Fds, Gg, Gg, Gg, Gg, Gg, Gg, Gg, Gg, Rr, Ch, Rr, Rr^Vhc, Rr, Ch, Ch, Ch, Ch, Ch, Rp, Gs^Fds, Gs^Fds, Ch, Gg, Gg, Gg, Gg, Gg
Gg, Gg, Gg, Gg, Re^Es, Gg, Gg, Gg, Gg, Gg, Gg, Gg, Gg, Gg, Gg, Gg, Gg, Gg, Gg, Gg, Gg, Gg, Rr, Rr, Rr, Gg, Rr, Rr, Gg, Rr, Rp, Rr, Rp, Rr, Ch, Kh, Ch, Rp, Rp, Ww^Ewl, Gs^Fds, Ch, Gg, Gg, Gg, Gg, Gg
Gg, Gg, Re, Re, Chr, Re^Es, Re, Gg, Gg, Gg, Rr, Gg, Gg, Gg, Gg, Gg, Rr, Gg, Rr, Gg, Rr, Rr, Gg, Gg, Gg, Rr, Gg, Gg, Gg, Ch, Rb^Vh, Rb^Vc, Rr, Ch, Ch, Ch, Ch, Ch, Rr, Gs^Fds, Rb^Vh, Ch, Gg, Gg, Gg, Gg, Gg
Rr, Rr, Rr, Khr, Chr, Chr, Rr, Gg, Rr, Rr, Gg, Rr, Rr, Gg, Rr, Rr, Gg, Rr, Gg, Rr, Gg, Gg, Gg, Gg, Gg, Gg, Gg, Gg, Gg, Ch, Ch, Rr, Rr^Vhc, Rp, Rr, Ch, Rr, Rr, Rr^Vhc, Rr, Rb^Vh, Ch, Gg, Gg, Gg, Gg, Gg
Gg, Gg, Re, Chr, Chr, Chr, Re, Rr, Gg, Gg, Gg, Gg, Gg, Rr, Gg, Gg, Gg, Gg, Gg, Gg, Gg, Gg, Gg, Gg, Gg, Gg, Gg, Gg, Gg, Gg, Ch, Rp, Rr, Rp, Rp, Rr, Rr, Rr^Vhc, Rp, Rp, Ch, Ch, Gg, Gg, Gs^Fds, Gs^Fds, Gg
Gg, Gg, Re, Chr, Khr, Chr, Re^Es, Gg, Gg, Gg, Gg, Gg, Gg, Gg, Gg, Gg, Gg, Gg, Gg, Gg, Gg, Gg, Gg, Gg, Gg, Gg, Gg, Gg, Gg, Gg, Gg, Ch, Ch, Rb^Vh, Ch, Rp, Ch, Rp, Ch, Rr, Rr, Gg, Gg, Gg, Gs^Fds, Gg, Gg
Gg, Gg, Gg, Re, Re, Re, Gg, Gg, Gg, Gg, Gg, Gg, Gs^Fds, Gs^Fds, Gg, Gg, Gs^Fds, Gg, Gg, Gg, Gs^Fds, Gg, Gg, Gg, Gg, Gg, Gg, Gg, Gg, Gg, Gg, Gg, Gg, Ch, Gg, Ch, Gg, Ch, Gg, Gg, Gg, Rr, Rr, Gs^Fds, Gs^Fds, Gs^Fds, Gg
Gg, Gg, Gg, Gg, Gg, Gg, Gg, Gg, Gg, Gg, Gs^Fds, Gs^Fds, Gs^Fds, Gs^Fds, Gs^Fds, Gs^Fds, Gg, Gg, Gs^Fds, Gs^Fds, Gs^Fds, Gs^Fds, Gg, Gg, Gg, Gg, Gg, Gg, Gg, Gg, Ds, Gg, Gg, Gg, Gg, Gg, Gg, Gg, Gg, Gg, Gg, Gg, Gg, Rr, Gg, Gg, Gg
Gg, Gg, Gg, Gg, Gg, Gg, Gg, Gg, Gs^Fds, Gs^Fds, Gs^Fds, Gs^Fds, Gs^Fds, Gs^Fds, Gs^Fds, Gs^Fds, Gs^Fds, Gg, Gg, Gs^Fds, Gg, Gg, Gs^Fds, Gs^Fds, Gg, Gg, Gg, Gg, Ds, Ds, Ds, Ds, Gg, Gg, Ds, Gg, Ds, Gg, Ds, Gg, Gg, Gg, Gg, Rr, Rr, Gg, Gg
Gg, Gg, Gg, Gg, Gg, Gg, Gs^Fds, Gs^Fds, Gg, Gs^Fds, Gs^Fds, Gs^Fds, Gs^Fds, Gs^Fds, Gs^Fds, Gs^Fds, Gs^Fds, Gg, Gs^Fds, Gg, Gs^Fds, Gs^Fds, Gg, Gg, Gg, Gg, Gg, Gg, Ds, Ds, Ds, Gg, Ds, Ds, Ds, Ds, Ds, Ds, Gg, Gg, Gg, Gs^Fds, Gg, Gg, Gg, Rr, Rr
Gg, Gg, Gg, Gg, Gs^Fds, Gs^Fds, Gg, Gg, Gg, Gg, Gg, Gs^Fds, Gs^Fds, Gs^Fds, Gs^Fds, Gs^Fds, Gs^Fds, Gs^Fds, Gs^Fds, Gs^Fds, Gg, Gg, Gg, Gg, Gg, Gg, Gg, Gg, Ds, Ds, Ds, Ds, Ds, Ds, Ds, Ds, Ds, Gg, Gg, Gg, Gg, Gg, Gg, Gg, Gg, Gg, Gg
Gg, Gg, Gg, Gs^Fds, Gg, Gg, Gg, Gg, Gg, Gg, Gg, Gg, Gs^Fds, Gs^Fds, Gg, Gs^Fds, Gs^Fds, Gs^Fds, Gs^Fds, Gs^Fds, Gg, Gg, Gg, Gg, Gg, Gg, Ds, Ds, Gg, Ds, Ds, Ds, Ds, Ds, Ds, Ds, Gg, Gg, Gg, Gg, Gg, Gg, Gg, Gg, Gg, Gg, Gg
Gg, Gg, Gg, Gg, Gg, Gg, Gg, Gg, Gg, Gg, Gg, Gg, Gg, Gg, Gg, Gs^Fds, Gs^Fds, Gs^Fds, Gg, Gg, Gg, Gg, Gg, Gg, Gg, Gg, Gg, Gg, Ds, Ds, Ds, Ds, Gg, Ds, Gg, Gg, Gg, Gg, Gg, Gg, Gg, Gg, Gg, Gg, Gg, Gg, Gg
Gg, Gg, Gg, Gg, Gg, Gg, Gg, Gg, Gs^Fds, Gs^Fds, Gs^Fds, Gg, Gg, Gg, Gg, Gs^Fds, Gg, Gg, Gg, Gg, Gg, Gg, Gs^Fds, Gg, Gg, Gg, Gg, Gg, Ds, Ds, Gg, Gg, Gg, Gg, Gg, Gg, Gg, Gg, Gg, Gg, Gg, Gg, Gg, Gg, Gg, Gg, Gg
Gs^Fds, Gs^Fds, Gs^Fds, Gg, Gg, Gg, Gs^Fds, Gs^Fds, Gs^Fds, Gs^Fds, Gs^Fds, Gs^Fds, Gs^Fds, Gg, Gg, Gg, Gs^Fds, Gs^Fds, Gs^Fds, Gg, Gs^Fds, Gs^Fds, Gg, Gg, Gs^Fds, Gg, Gg, Gg, Gg, Gg, Gg, Gg, Gg, Gg, Gg, Gg, Gg, Gg, Ds, Gg, Ds, Gg, Gg, Gg, Gg, Gg, Gg
Gs^Fds, Gs^Fds, Gs^Fds, Gg, Gg, Gg, Gg, Gs^Fds, Gs^Fds, Gs^Fds, Gs^Fds, Gs^Fds, Gs^Fds, Gs^Fds, Gs^Fds, Gs^Fds, Gs^Fds, Gs^Fds, Gs^Fds, Gs^Fds, Gg, Gg, Gs^Fds, Gs^Fds, Gs^Fds, Gg, Gg, Gg, Gg, Gg, Gg, Gg, Gg, Gg, Gg, Gg, Ds, Ds, Ds, Ds, Ds, Gg, Ds, Gg, Ds, Ds, Ds
Gs^Fds, Gs^Fds, Gs^Fds, Gg, Gg, Gg, Gg, Gs^Fds, Gg, Gs^Fds, Gs^Fds, Gs^Fds, Gs^Fds, Gs^Fds, Gg, Gg, Gg, Gg, Gg, Gg, Gs^Fds, Gg, Gs^Fds, Gs^Fds, Gg, Gg, Ds, Ds, Ds, Ds, Gg, Gg, Gg, Gg, Gg, Gg, Ds, Ds, Ds, Ds, Ds, Ds, Ds, Ds, Ds, Ds, Gg
Gs^Fds, Gs^Fds, Gs^Fds, Gs^Fds, Gs^Fds, Gg, Gg, Gg, Gg, Gg, Gs^Fds, Gs^Fds, Gg, Gg, Gg, Gg, Gg, Gg, Gs^Fds, Gs^Fds, Gs^Fds, Gg, Gg, Gg, Gg, Ds, Ds, Ds, Ds, Ds, Gg, Gg, Gg, Gg, Ds, Ds, Gg, Ds, Gg, Ds, Ds, Ds, Gg, Ds, Gg, Gg, Gg
Gs^Fds, Gs^Fds, Gs^Fds, Gs^Fds, Gg, Gg, Gg, Gg, Gg, Gg, Gg, Gg, Gg, Gg, Gg, Gg, Gg, Gs^Fds, Gs^Fds, Gs^Fds, Gg, Gg, Gg, Gg, Ds, Ds, Ds, Ds, Gg, Gg, Gg, Gg, Gg, Gg, Gg, Gg, Gg, Gg, Gg, Ds, Gg, Gg, Gg, Gg, Gg, Gg, Gg
