Hh, Hh, Hh, Gg, Gg, Gg, Gg, Gg, Gg, Gg, Hh, Ds, Hh, Hh, Hh, Hh, Gg, Ww, Gg, Gg, Hh, Hh, Hh, Gs^Vh, Hh, Gg, Hh, Hh, Hh, Hh, Gs^Fds, Gs^Fds, Hh, Gg, Gg, Gs^Fds, Gs^Fds, Gs^Fds, Gs^Fds, Gs^Fds, Gs^Fds, Gg, Gg, Gs^Fds, Gs^Fds, Gs^Fds, Gg, Gg, Rr, Rr, Gg, Gg, Gg
Hh, Hh, Gg, Gg, Gg, Gg, Gs^Fms, Gs^Fms, Hh, Hh, Hh, Hh, Hh, Hh, Hh, Hh, Hh, Ww, Ww, Gs^Fms, Hh, Hh, Hh, Hh, Hh, Hh, Gs^Fds, Gg, Gs^Fds, Gg, Hh, Gs^Fds, Gg, Hh, Re^Gvs, Gs^Fds, Gs^Fds, Gs^Fds, Gs^Fds, Gs^Fds, Gg, Gs^Fds, Gg, Gg, Gg, Gg, Rr, Rr, Gs^Vh, Gg, Gg, Gg, Gs^Fds
Hh, Hh, Hh, Gg, Gg, Gg, Gg, Gg, Gg, Gs^Vh, Gg, Hh, Gg, Gg, Gg, Gg, Gs^Vh, Gg, Gg, Ww, Gs^Fms, Gs^Fms, Hh, Hh, Hh, Hh, Hh, Hh, Hh, Gs^Fds, Hh, Hh, Hh, Gg, Re^Gvs, Re^Gvs, Re^Gvs, Gg, Gg, Gg, Gg, Gg, Gg, Gg, Rr, Rr, Gg, Gg, Gs^Fds, Gs^Fds, Gg, Gg, Gs^Fds
Hh, Hh, Hh, Hh, Hh, Gg, Gg, Gg, Re^Gvs, Re^Gvs, Re^Gvs, Re^Gvs, Re^Gvs, Re^Gvs, Gg, Gg, Gg, Re^Gvs, Gs^Fms, Ww, Ww, Hh, Hh, Hh, Gs^Fms, Hh, Gg, Hh, Hh, Hh, Hh, Hh, Re^Gvs, Gs^Vh, Gs^Fds, Re^Gvs, Re^Gvs, Gg, Gs^Fds, Gs^Fds, Re^Gvs, Re^Gvs, Gg, Gg, Rr, Gg, Gs^Fds, Gg, Gs^Fds, Gs^Fds, Gs^Fds, Gs^Fds, Gs^Fds
Hh, Hh, Hh, Gg, Gs^Vh, Gg, Gg, Gg, Gg, Re^Gvs, Gg, Re^Gvs, Gg, Gg, Gg, Gg, Hh, Hh, Gg, Gg, Gg, Ww, Wwf, Gs^Fms, Gg, Gs^Vh, Hh, Hh, Hh, Hh, Gs^Fms, Gg, Gg, Re^Gvs, Gs^Fds, Gs^Fds, Gs^Fds, Gs^Fds, Re^Gvs, Re^Gvs, Re^Gvs, Gs^Vh, Rr, Rr, Gs^Fds, Gs^Fds, Gs^Fds, Gs^Fds, Gs^Fds, Gs^Fds, Gs^Fds, Gs^Fds, Gs^Fds
Gs^Fms, Gs^Fms, Gg, Gg, Re^Gvs, Re^Gvs, Re^Gvs, Gg, Gg, Gg, Gg, Gg, Gs^Fms, Gs^Fms, Hh, Hh, Hh, Hh, Hh, Re^Gvs, Gg, Ww, Hh, Wwf, Wwf, Hh, Hh, Hh, Hh, Gs^Fms, Hh, Hh, Hh, Gs^Fds, Hh, Gs^Fds, Gs^Fds, Gg, Re^Gvs, Re^Gvs, Rr, Rr, Gg, Gs^Fds, Gg, Gs^Fds, Gs^Fds, Gs^Fds, Gs^Fds, Gs^Fds, Gg, Gs^Fds, Gg
Gs^Fms, Gg, Gs^Fms, Re^Gvs, Gs^Fms, Re^Gvs, Re^Gvs, Re^Gvs, Re^Gvs, Gg, Re^Gvs, Gg, Gg, Hh, Gg, Gg, Re^Gvs, Gg, Gs^Vh, Gg, Ww, Ww, Hh, Hh, Gg, Hh, Gs^Fms, Hh, Gg, Hh, Gs^Fms, Hh, Hh, Hh, Hh, Gs^Fds, Gg, Gg, Rr, Rr, Gg, Gg, Gg, Gg, Gs^Fds, Gs^Fds, Gs^Fds, Gg, Gs^Fds, Gs^Fds, Gs^Fds, Gs^Fds, Gg
Gg, Gs^Fms, Gg, Gg, Gg, Gs^Fms, Re^Gvs, Re^Gvs, Re^Gvs, Re^Gvs, Gg, Gg, Gg, Gs^Fms, Gg, Re^Gvs, Re^Gvs, Re^Gvs, Ww, Ww, Hh, Hh, Hh, Hh, Gs^Fms, Gs^Fms, Gg, Gg, Gs^Fms, Gg, Hh, Hh, Gg, Gs^Vh, Hh, Gg, Gg, Rr, Gg, Gg, Re^Gvs, Gs^Vh, Gs^Fds, Gs^Fds, Gs^Fds, Gs^Fds, Gg, Gg, Gs^Fds, Gs^Fds, Gs^Fds, Gs^Fds, Gg
Gs^Fms, Gg, Gs^Fms, Gs^Fms, Gg, Re^Gvs, Re^Gvs, Re^Gvs, Gg, Re^Gvs, Gg, Gs^Vh, Gg, Gg, Gg, Gg, Gg, Gg, Ww, Hh, Gg, Gg, Wwf, Wwf, Hh, Hh, Hh, Hh, Hh, Hh, Hh, Hh, Gg, Gg, Gg, Gg, Rr, Rr, Re^Gvs, Gg, Gg, Re^Gvs, Gg, Gg, Gg, Gs^Fds, Gs^Fds, Gg, Gg, Gs^Fds, Gs^Fds, Gs^Fds, Gs^Fds
Gs^Fms, Gs^Fms, Gg, Gs^Fms, Gg, Gs^Fms, Gg, Gg, Gg, Gg, Gg, Gg, Gs^Fms, Gg, Hh, Gg, Hh, Gg, Ww, Gg, Ww, Wwf, Gg, Hh, Gs^Vh, Hh, Gg, Hh, Hh, Hh, Ch, Ch, Ch, Gg, Rr, Rr, Gs^Fds, Gs^Fds, Re^Gvs, Gg, Gs^Fds, Gg, Gg, Gg, Gg, Gg, Gg, Gg, Gg, Gg, Gs^Fds, Gs^Fds, Gg
Gg, Gs^Fms, Gg, Gg, Chr, Gg, Gg, Gg, Re^Gvs, Gg, Gs^Fms, Hh, Hh, Hh, Hh, Hh, Gg, Gg, Gg, Ww, Gs^Fms, Ww, Gg, Gg, Re^Gvs, Gg, Gg, Gg, Ch, Ch, Rr, Ch, Rr^Vhc, Rr, Ch, Gg, Gg, Re^Gvs, Re^Gvs, Gs^Fds, Re^Gvs, Gs^Fds, Ds, Ds, Gg, Gg, Gg, Gg, Gs^Fds, Gs^Fds, Gs^Fds, Gg, Gg
Gg, Gg, Gg, Gg, 2 Khr, Chr, Chr, Gg, Re^Gvs, Gg, Gg, Gg, Gg, Hh, Gs^Fms, Re^Gvs, Re^Gvs, Re^Gvs, Re^Gvs, Gg, Gs^Fms, Ww, Gg, Re^Gvs, Re^Gvs, Gg, Gg, Ch, Rr^Vhc, Rr^Vhc, Rr, Ch, Rr^Vhc, Rr, Rr^Vhc, Ch, Gg, Gs^Vh, Re^Gvs, Re^Gvs, Re^Gvs, Ds, Ds, Gg, Ds, Gg, Gg, Gg, Gg, Gg, Gg, Ss, Ss
Rr, Gg, Rr, Chr, Chr, Gg, Gg, Re^Gvs, Re^Gvs, Gs^Vh, Re^Gvs, Gg, Gg, Gs^Fms, Re^Gvs, Re^Gvs, Re^Gvs, Re^Gvs, Gg, Gs^Vh, Ww, Ww, Gg, Gs^Fms, Gg, Gg, Gg, Ch, Rr, Rr^Vhc, Ch, Ch, Ch, Rr, Ch, Ch, Gg, Gg, Re^Gvs, Re^Gvs, Ds, Ds, Ds, Ds, Gs^Fds, Gg, Gg, Gg, Gg, Gg, Ss, Ss, Ss
Gg, Rr, Chr, Rr, Rr, Gg, Rr, Re^Gvs, Gg, Re^Gvs, Gg, Gg, Gg, Gg, Gg, Gg, Gg, Gg, Gg, Ww, Rr, Gg, Rr, Gg, Rr, Rr, Rr, Rr, Rr, Ch, Ch, 3 Kh, Ch, Ch, Ch, Ch, Gg, Gg, Gg, Ds, Re^Gvs, Gs^Fds, Re^Gvs, Gs^Fds, Gs^Fds, Gg, Gg, Gs^Vh, Gs^Fds, Ss, Gs^Fds, Ss, Ss
Gg, Gg, 1 Khr, Chr, Gg, Rr, Gg, Rr, Rr, Gg, Rr, Rr, Rr, Rr, Rr, Gg, Rr, Gg, Rr, Ww^Bsb/, Gg, Rr, Gg, Rr, Gg, Gg, Gg, Ch, Rr^Vhc, Rr^Vhc, Rr, Ch, Rr, Rr^Vhc, Rr^Vhc, Ch, Gg, Gg, Re^Gvs, Re^Gvs, Re^Gvs, Gs^Vh, Re^Gvs, Re^Gvs, Gg, Gg, Gg, Gs^Fds, Gs^Fds, Gs^Fds, Gs^Fds, Ss, Gg
Gg, Gg, Chr, Chr, Re^Gvs, Re^Gvs, Gs^Vh, Gg, Gg, Rr, Gg, Re^Gvs, Re^Gvs, Gg, Gs^Fds, Rr, Gg, Rr, Gs^Fds, Ww, Re^Gvs, Re^Gvs, Re^Gvs, Gs^Vh, Re^Gvs, Gg, Gg, Ch, Ch, Rr^Vhc, Rr, Ch, Rr, Rr^Vhc, Ch, Ch, Gg, Gg, Re^Gvs, Re^Gvs, Re^Gvs, Re^Gvs, Gs^Fds, Gs^Fds, Re^Gvs, Re^Gvs, Gg, Gg, Gs^Fds, Gs^Fds, Gs^Fds, Gg, Gg
Gg, Gg, Chr, Re^Gvs, Re^Gvs, Re^Gvs, Gg, Gg, Re^Gvs, Gg, Gs^Vh, Re^Gvs, Re^Gvs, Gs^Fms, Ds, Gg, Ds, Gs^Fds, Ww, Ww, Re^Gvs, Re^Gvs, Re^Gvs, Re^Gvs, Re^Gvs, Re^Gvs, Gg, Gg, Gg, Ch, Ch, Ch, Ch, Rr, Rr, Gg, Gg, Gg, Gs^Fds, Gg, Gg, Gg, Gs^Fds, Gs^Fds, Gs^Vh, Re^Gvs, Gg, Gs^Fds, Gg, Gs^Fds, Gs^Fds, Gs^Fds, Gg
Gg, Gg, Gg, Re^Gvs, Re^Gvs, Gg, Gg, Gg, Re^Gvs, Re^Gvs, Gg, Gg, Gg, Gg, Ds, Ds, Ww, Ww, Re^Gvs, Re^Gvs, Gs^Fds, Re^Gvs, Re^Gvs, Re^Gvs, Gg, Gg, Ds, Gg, Gg, Gg, Gg, Ch, Gg, Gg, Rr, Gg, Gs^Fds, Gs^Vh, Re^Gvs, Gs^Fds, Gg, Gs^Fds, Gs^Fds, Gs^Fds, Gs^Fds, Gg, Gg, Gg, Ds, Gs^Fds, Ds, Ds, Ds
Gg, Gg, Gg, Gg, Gg, Gg, Gg, Gg, Gg, Gg, Ds, Ds, Gg, Gg, Ds, Ww, Gg, Gg, Gg, Gs^Fds, Gg, Gs^Fms, Gg, Gg, Ds, Gg, Ds, Gg, Gg, Gg, Gg, Gg, Gg, Gg, Gg, Rr, Rr, Re^Gvs, Re^Gvs, Re^Gvs, Gg, Ds, Ds, Ds, Gg, Gs^Fds, Ds, Gg, Gg, Ds, Ds, Ds, Ds
Gg, Gg, Gg, Gg, Gg, Gg, Gg, Gg, Ds, Ds, Ds, Gg, Ds, Ds, Ww, Ww, Gg, Gs^Vh, Gg, Gg, Gg, Gg, Gg, Gg, Ds, Ds, Ds, Ds, Ds, Gg, Ds, Ds, Ds, Ds, Ds, Gg, Gg, Rr, Gg, Gg, Ds, Ds, Ds, Ds, Gg, Ds, Gg, Gg, Gg, Ds, Gg, Gg, Gg
Gg, Gg, Gg, Gg, Gs^Fds, Gg, Gg, Ds, Ds, Ds, Gg, Ds, Ds, Ww, Ds, Gg, Re^Gvs, Re^Gvs, Re^Gvs, Re^Gvs, Gg, Gg, Gg, Ds, Gg, Ds, Ds, Ds, Ds, Ds, Ds, Ds, Ds, Ds, Re^Gvs, Re^Gvs, Gg, Rr, Gg, Ds, Ds, Gs^Vh, Ds, Gg, Gg, Gg, Ds, Ds, Ds, Gg, Gg, Gg, Gg
Gg, Gg, Gg, Gg, Gs^Vh, Gg, Gg, Ds, Gg, Gg, Gs^Fds, Gg, Ds, Ww, Ds, Re^Gvs, Re^Gvs, Re^Gvs, Re^Gvs, Re^Gvs, Re^Gvs, Gg, Gs^Fds, Gg, Gg, Gg, Ds, Ds, Ds, Gg, Ds, Ds, Gg, Gg, Re^Gvs, Re^Gvs, Re^Gvs, Rr, Rr, Ds, Gg, Gg, Ds, Ds, Ds, Ds, Ds, Ds, Gg, Gg, Ds, Ds, Ds
Gg, Gg, Gs^Fds, Gs^Fds, Re^Gvs, Re^Gvs, Re^Gvs, Gg, Re^Gvs, Gs^Fds, Gs^Fds, Gg, Gg, Ww, Ww, Gg, Gg, Re^Gvs, Re^Gvs, Re^Gvs, Gs^Fds, Gs^Vh, Gg, Gg, Ds, Gg, Ds, Ds, Gg, Gg, Gg, Gg, Gg, Gg, Re^Gvs, Gs^Vh, Re^Gvs, Gg, Rr, Gg, Gg, Gg, Re^Gvs, Ds, Gs^Vh, Ds, Ds, Ds, Gg, Gg, Ds, Ds, Ds
Gg, Gg, Re^Gvs, Re^Gvs, Re^Gvs, Re^Gvs, Re^Gvs, Re^Gvs, Gg, Gs^Fds, Gg, Gg, Gg, Gs^Vh, Ww, Ds, Gg, Gg, Gg, Gg, Gs^Fds, Gs^Fds, Gg, Ds, Gg, Ds, Gg, Ds, Ds, Gg, Ds, Ds, Gg, Ds, Gg, Gg, Gg, Gg, Gg, Rr, Rr, Gg, Gg, Re^Gvs, Re^Gvs, Gg, Gg, Gg, Gg, Ds, Ds, Ds, Ds
Gg, Gg, Gg, Gg, Gg, Gg, Gg, Gg, Gg, Gg, Re^Gvs, Gg, Re^Gvs, Ds, Ww, Ds, Ds, Ds, Gg, Gg, Gg, Gg, Gg, Gs^Fds, Gg, Gg, Gg, Ds, Ds, Ds, Ds, Ds, Ds, Ds, Ds, Gg, Ds, Gg, Gg, Gg, Gg, Rr, Rr, Re^Gvs, Re^Gvs, Gg, Gg, Ds, Ds, Ds, Ds, Ds, Ds
Gg, Gg, Gg, Gg, Ds, Gg, Gg, Gg, Re^Gvs, Re^Gvs, Re^Gvs, Re^Gvs, Re^Gvs, Ds, Ww, Ds, Ds, Ds, Ds, Gg, Gg, Gg, Gg, Gg, Gg, Gg, Ds, Ds, Ds, Ds, Ds, Ds, Gg, Ds, Ds, Ds, Gg, Ds, Gg, Gg, Gg, Gg, Gg, Rr, Rr, Re^Gvs, Gg, Ds, Ds, Ds, Ds, Ds, Ds
Gg, Gg, Ds, Ds, Gg, Gg, Gg, Gg, Gs^Fds, Gs^Fds, Gs^Vh, Re^Gvs, Re^Gvs, Re^Gvs, Gs^Fds, Ww, Ds, Ds, Ds, Ds, Gg, Gg, Gg, Gg, Gg, Gg, Ds, Ds, Ds, Ds, Re^Gvs, Gs^Vh, Gg, Gg, Gg, Gg, Ds, Gg, Gg, Gg, Gg, Gg, Gg, Gg, Rr, Gg, Gg, Gg, Gg, Ds, Ds, Ds, Ds
