Wo, Mm, Mm, Mm, Mm, Mm, Mm, Mm, Mm, Mm, Mm, Mm, Mm, Mm, Ms, Ms, Ms, Ms, Ms, Ha, Ha, Ha
Mm, Wo, Wo, Mm, Hh, Hh, Hh^Vo, Mm, Hh, Mm, Hh^Vo, Mm, Mm, Mm, Mm, Ms, Ms, Ms, Ms, Ha, Ha, Aa
Mm, Mm, Mm, Ww, Wo, Mm, Mm, Hh, Hh^Vo, Hh, Hh, Hh, Hh, Mm, Mm, Mm, Mm, Ms, 3 Kea, Ha, Aa, Aa
Mm, Mm, Mm^Vo, Mm, Mm, Wo, Mm, Mm, Mm, Mm, Mm, Mm, Mm, Mm, Mm, Mm, Hh, Cea, Cea, Cea, Ms, Ms
Mm, Mm, Hh, Mm, Mm, Wo, Ww, Mm, Mm, Mm, Mm, Mm, Mm, Hh, Hh, Hh, Hh, Hh, Mm, Hh, Ms, Ms
Mm, Mm, Hh, Mm, Mm, Mm, Mm, Wo, Wo, Mm, Mm, Mm, Mm, Hh^Vo, Mm, Mm, Mm, Mm, Mm, Mm, Mm, Ms
Mm, Hh, Mm, Mm, Hh, Hh^Vo, Mm, Mm, Wo, Mm, Mm, Mm, Mm, Mm, Hh, Mm, Mm, Mm, Mm, Mm, Mm, Mm
Hh, Hh, Hh^Vo, Mm, Hh, Mm, Mm, Mm, Mm, Ww, Wo, Mm, Mm, Mm, Hh, Mm, Hh^Vo, Mm, Mm, Mm, Mm, Mm
Hh, Mm, Hh, Mm, Hh, Mm, Hh, Hh, Mm, Mm, Mm, Wo, Mm, Mm, Hh, Hh, Mm, Mm, Mm, Mm, Mm, Mm
Hh, Hh, 1 Kte, Cte, Cte, Hh, Mm, Mm, Mm, Mm^Vo, Mm, Wo, Wo, Hh, Mm, Mm, Mm, Mm, Mm, Hh^Vo, Mm, Mm
Hh, Hh, Hh, Cte, Hh, Hh, Hh, Mm, Mm, Mm, Mm, Mm, Mm, Wo, Wo, Mm, Mm, Hh, Hh, Hh, Mm, Mm
Mm, Hh, 2 Kte, Cte, Cte, Hh, Mm, Hh^Vo, Hh, Mm, Mm, Mm, Mm, Mm, Ww, Wo, Mm, Hh, Hh^Vo, Hh, Mm, Mm
Mm, Mm, Hh, Cte, Hh, Mm, Mm, Mm, Mm, Hh, Hh, Hh^Vo, Hh, Mm, Ww, Mm, Mm, Mm, Mm, Mm, Mm, Mm
Mm, Mm, Hh^Vo, Hh, Mm, Mm, Mm, Mm, Mm, Hh, Mm, Mm, Hh, Mm, Mm, Ww, Wo, Mm, Mm, Mm, Mm, Mm
Wo, Mm, Mm, Mm, Mm, Mm, Mm, Mm, Mm, Hh, Mm, Mm, Mm, Hh, Mm^Vo, Mm, Mm, Wo, Mm, Mm, Mm, Mm
Mm, Wo, Ww, Mm, Mm, Mm, Wo, Mm, Mm, Hh, Mm^Vo, Mm, Mm, Mm, Mm, Mm, Mm, Wo, Wo, Mm, Mm, Mm
Mm, Mm, Hh^Vo, Wo, Wo, Wo, Mm, Wo, Ww, Hh, Ww, Mm, Wo, Mm, Mm, Mm^Vo, Mm, Mm^Vo, Mm, Wo, Wo, Mm
Mm, Mm, Hh, Mm, Mm, Wo, Mm, Mm, Mm, Ww, Hh, Wo, Mm, Wo, Wo, Mm, Wo, Mm, Wo, Mm, Wo, Wo
Mm, Mm, Mm, Hh, Mm, Mm, Mm, Mm, Hh, Hh^Vo, Mm, Mm, Mm, Mm, Mm, Wo, Mm, Wo, Mm, Wo, Wo, Wo
Mm, Mm, Mm, Mm^Vo, Mm, Mm, Hh^Vo, Hh, Mm, Hh, Mm, Mm, Hh^Vo, Mm, Mm, Mm, 4 Ke, Mm, Mm, Mm, Mm, Wo
Mm, Mm, Mm, Mm, Mm, Mm, Mm, Mm, Mm, Mm, Mm, Hh, Hh, Hh, Hh, Ce, Ce, Ce, Mm, Mm, Mm, Mm
Mm, Mm, Mm, Mm, Mm, Mm, Mm, Mm, Mm, Mm, Hh, Hh, Hh, Hh, Hh, Hh, Hh, Mm, Mm, Mm, Mm, Mm
