Mm, Mm, Mm, Mm, Mm, Mm, Hh, Hh, Hh, Hh, Hh, Gs^Fms, Gs^Fms, Gs^Fms, Hh, Hh, Hh, Hh, Hh, Hh, Gg, Gg, Gg, Rr, Gg, Gg
Mm, Mm, Mm, Mm, Mm, Mm, Hh, Hh, Hh, Hh, Hh^Fms, Gs^Fms, Gs^Fds, Gs^Fms, Hh^Fms, Hh, Hh, Gg, Gg, Gg, Ch, Gg, Gg, Rr, Gg, Gg
Mm, Mm, Mm, Mm, Hh, Hh, Hh, Hh, Hh, Hh, Hh^Fms, Gs^Fms, Gs^Fds, Gs^Fms, Hh, Hh, Hh, Gg, Gg, Ch, Kh, Ch, Rr, Rr, Gg, Gg
Hh, Hh, Hh, Hh, Hh, Hh, Ww, Gs^Fms, Hh^Fms, Hh, Hh, Hh, Gg, Hh, Gg, Gg, Gg, Gg, Gg, Ch, Gg, Ch, Rr, Gg, Gg, Gg
Hh, Hh, Ww, Ww, Ww, Ww, Gs^Fms, Gs^Fms, Gs^Fds, Gs^Fds, Gs^Fds, Gs^Fms, Gs^Fms, Gg, Rr, Gg, Rr, Gg, Gg, Gg, Rr, Rr, Gg, Gg, Gg, Gg
Mm, Mm, Hh, Wo, Wo, Ww, Gs^Fms, Gs^Fms, Gs^Fds, Gs^Fds, Gs^Fms, Gs^Fds, Rr, Rr, Gg, Rr, Gg, Rr, Rr, Rr, Gs^Fds, Gs^Fds, Gg, Gs^Fds, Gs^Fds, Gs^Fms
Mm, Mm, Hh, Hh, Wo, Ww, Ww, Gs^Fms, Gs^Fms, Gs^Fms, Gs^Fms, Rr, Gg, Gg, Hh, Gg, Gg, Gg, Gg, Rr, Gs^Fds, Gs^Fms, Gs^Fds, Gs^Fds, Gs^Fms, Gs^Fds
Mm, Mm, Mm, Hh, Ww, Ww, Ds, Ds, Gs^Fms, Gg, Rr, Rr, Gg, Gg, Hh, Gg, Gg, Gg, Gg, Rr, Gs^Fms, Gs^Fds, Gs^Fds, Gs^Fds, Gs^Fms, Gs^Fds
Mm, Mm, Mm, Mm, Hh, Hh, Gg, Gg, Gg, Rr, Gg, Gg, Gg, Mm, Hh, Hh, Gg, Gg, Gg, Rr, Gg, Gs^Fms, Gs^Fms, Gs^Fms, Gs^Fms, Gs^Fds
Hh, Hh, Mm, Hh, Mm, Hh, Hh, Gg, Rr, Rr, Hh, Hh, Gg, Mm, Mm, Hh, Hh, Gg, Hh, Rr, Gg, Gs^Fms, Gs^Fms, Gs^Fms, Gg, Gg
Hh, Hh, Mm, Hh, Hh, Gg, Rr, Rr, Gg, Gg, Hh, Hh, Mm, Mm, Mm, Hh, Hh, Gg, Hh, Rr, Gg, Gg, Gg, Gg, Gg, Gg
Gg, Gg, Hh, Ch, Rr, Rr, Gg, Gg, Gg, Hh, Hh, Mm, Mm, Mm, Mm, Mm, Hh, Hh, Hh, Rr, Rr, Gg, Gg, Gg, Gg, Gg
Gg, Gg, Ch, Kh, Ch, Gg, Gg, Gg, Gg, Hh, Mm, Mm, Mm, Mm, Mm, Mm, Mm, Hh, Hh, Hh, Rr, Gg, Gg, Gg, Gg, Gg
Gg, Gg, Gg, Ch, Gg, Gg, Gg, Gg, Hh, Mm, Mm, Mm, Hh, Hh, Mm, Mm, Mm, Hh, Hh, Hh, Rr, Gg, Gg, Gg, Gg, Gg
Gg, Gg, Gg, Rr, Gg, Gg, Gg, Gg, Hh, Mm, Mm, Hh, Hh, Hh, Hh, Mm, Mm, Mm, Hh, Hh, Gg, Rr, Gg, Ss, Gg, Gg
Gg, Gg, Gg, Rr, Gg, Gg, Mm, Hh, Mm, Mm, Hh, Hh, Mm, Mm, Mm, Hh, Mm, Mm, Hh, Hh, Gg, Rr, Gg, Ss, Gg, Gg
Gg, Gg, Gg, Rr, Gg, Mm, Mm, Mm, Mm, Mm, Hh, Hh, Mm, 3 Mm^Kov, Mm, Hh, Hh, Hh, Mm, Hh, Gg, Rr, Rr, Gg, Gg, Gg
Gg, Gg, Gg, Rr, Rr, Hh, Mm, Mm, Mm, Mm, Hh, Ww, Mm, Mm, Mm, Hh, Mm, Mm, Mm, Hh, Gg, Gg, Rr, Gg, Ss, Gg
Gg, Gg, Gg, Gg, Rr, Hh, Hh, Mm, Mm, Mm, Hh, Hh, Mm, Hh, Hh, Mm, Mm, Mm, Mm, Mm, Hh, Hh, Rr, Gg, Gg, Ss
Gs^Fms, Gs^Fms, Gs^Fms, Gg, Rr, Hh, Hh, Hh, Mm, Mm, Mm, Hh, Hh, Hh, Hh, Mm, Mm, Hh, Mm, Mm, Mm, Hh, Gg, Rr, Gg, Ss
Gs^Fms, Gs^Fms, Gs^Fms, Gs^Fms, Rr, Hh, Hh, Hh, Mm, Mm, Mm, Mm, Hh, Hh, Hh, Mm, Mm, Hh, Hh, Mm, Hh, Mm, Gg, Rr, Gg, Gg
Gs^Fms, Gs^Fms, Gg, Rr, Gs^Fms, Hh, Hh^Fms, Hh, Hh, Hh, Mm, Mm, Hh, Hh, Mm, Mm, Mm, Hh, Hh, Hh, Ss, Hh, Ss, Rr, Ss, Gg
Gs^Fms, Gs^Fms, Gg, Rr, Hh, Hh, Gs^Fms, Hh^Fms, Hh, Hh, Mm, Mm, Mm, Mm, Mm, Mm, Hh, Hh, Hh, Hh, Ss, Ss, Rr, Rr, Ss, Hh
Gs^Fms, Gs^Fms, Gs^Fms, Rr, Gs^Fms, Gs^Fms, Gs^Fms, Gs^Fms, Gs^Fms, Hh, Hh^Fms, Mm, Mm, Mm, Mm, Hh, Hh, Hh, Hh^Fms, Hh, Ss, Ss, Rr, Ss, Hh, Hh
Gs^Fms, Gs^Fms, Gs^Fms, Rr, Gs^Fms, Hh, Hh, Gs^Fms, Gs^Fms, Hh^Fms, Gs^Fms, Hh, Mm, Mm, Hh, Hh, Hh^Fms, Gs^Fms, Hh^Fms, Hh, Rr, Rr, Ss, Ss, Hh, Hh
Gs^Fms, Gs^Fms, Gs^Fms, Rr, Rr, Gs^Fms, Gs^Fms, Hh, Gs^Fms, Gs^Fms, Hh, Hh^Fms, Hh, Mm, Hh, Hh^Fms, Gs^Fms, Gs^Fms, Gs^Fms, Rr, Gg, Ss, Hh, Ss, Hh, Hh
Gs^Fms, Gs^Fms, Gs^Fms, Gg, Gs^Fms, Rr, Rr, Gg, Gg, Hh, Hh, Gs^Fms, Gs^Fms, Hh, Hh^Fms, Gs^Fms, Hh, Hh, Gs^Fms, Rr, Gg, Gg, Hh, Hh, Mm, Mm
Gs^Fms, Gs^Fms, Gs^Fms, Gg, Gg, Gs^Fms, Gs^Fms, Rr, Gs^Fms, Hh, Gs^Fms, Hh, Hh^Fms, Gs^Fms, Hh^Fms, Gs^Fms, Rr, Hh, Rr, Rr, Gg, Hh, Hh, Mm, Mm, Mm
Gs^Fms, Gs^Fms, Gg, Gs^Fms, Gs^Fms, Gs^Fms, Gs^Fms, Rr, Rr, Gs^Fms, Hh, Hh^Fms, Hh, Gs^Fms, Gs^Fms, Rr, Gg, Rr, Gg, Gg, Gg, Hh, Hh, Mm, Mm, Mm
Gs^Fms, Gs^Fms, Gg, Gs^Fms, Gs^Fms, Gs^Fms, Gs^Fms, Gs^Fms, Gs^Fms, Rr, Rr, Rr, Rr, Gs^Fms, Rr, Rr, Gs^Fms, Gg, Hh, Mm, Mm, Hh, Hh, Hh, Mm, Mm
Gg, Gg, Gg, Gs^Fms, Gg, Gs^Fms, Gs^Fms, Gg, Gg, Gg, Rr, Gs^Fms, Gs^Fms, Rr, Gs^Fms, Gg, Gs^Fms, Hh, Hh, Mm, Mm, Mm, Hh, Hh, Hh, Hh
Gg, Gg, Gg, Gg, Gg, Gg, Gg, Gg, Gg, Gg, Rr, Gs^Fms, Gs^Fms, Gs^Fms, Gs^Fms, Gg, Hh, Hh, Gs^Fms, Mm, Mm, Mm, Hh, Hh, Hh, Hh
Gg, Gg, Gg, Gg, Gg, Gs^Fms, Gg, Gg, Rr, Rr, Gg, Gs^Fms, Gs^Fms, Gs^Fms, Gs^Fms, Gs^Fms, Hh, Hh, Gs^Fms, Hh, Mm, Mm, Hh, Hh, Hh, Hh
Gg, Gg, Gg, Gg, Gs^Fms, Gs^Fms, Gs^Fms, Rr, Gg, Gg, Gg, Gs^Fms, Gs^Fms, Gs^Fds, Gg, Gs^Vh, Gs^Fms, Gs^Fds, Gs^Fms, Gs^Fms, Hh, Gs^Fms, Hh, Hh, Hh, Hh
Gg, Gg, Gg, Gg, Gg, Gs^Fds, Gs^Fds, Rr, Gg, Gg, Gg, Gg, Gs^Fms, Gs^Fds, Rr^Vhc, Gg, Gs^Fds, Gs^Fds, Ch, Gs^Fms, Gs^Fms, Gs^Fms, Hh, Hh, Hh, Hh
Gg, Gg, Gg, Gg, Gg, Gs^Fds, Rr, Rr, Rr, Gg, Rr, Gg, Gg, Gs^Fms, Rr, Gg, Gg, Gg, Ch, Kh, Gs^Fds, Gs^Fds, Gs^Fms, Hh, Hh, Hh
Gg, Gg, Gg, Gg, Gg, Rr, Gg, Gg, Gg, Rr, Gg, Rr, Rr, Rr, Gs^Fms, Rr, Rr, Rr, Gs^Fds, Ch, Gs^Fms, Gs^Fms, Hh, Hh, Hh, Hh
Gg, Gg, Cer, Cer, Cer, Rr, Cer, Gg, Gg, Gg, Gg, Gg, Gg, Gg, Gs^Fms, Gs^Fms, Gs^Fms, Gs^Fms, Gs^Fds, Gs^Fms, Hh, Gs^Fms, Hh, Mm, Mm, Mm
Gg, Gg, Gg, 1 Ker, Rr, Rr, 2 Ker, Cer, Gg, Gg, Gg, Gg, Gg, Gg, Gs^Vh, Gs^Fms, Gs^Fds, Gs^Fds, Gs^Fds, Gs^Fms, Hh, Mm, Mm, Mm, Mm, Mm
Gg, Gg, Gg, Gg, Rr, Gg, Gg, Cer, Gg, Gg, Gg, Gg, Gs^Fms, Gg, Gs^Fms, Gs^Fds, Gs^Fds, Gs^Fds, Gs^Fms, Hh, Hh, Mm, Mm, Mm, Mm, Mm
Gg, Gg, Gg, Gg, Rr, Gg, Gg, Gg, Gg, Gg, Gg, Gg, Gs^Fms, Gs^Fms, Gs^Fms, Gs^Fds, Gs^Fds, Gs^Fds, Hh, Hh, Hh, Mm, Mm, Mm, Mm, Mm
